Fall,College,Major Name,Total,Male,Female
1981,Business,Accountancy,1433,816,617
1981,Business,Accountancy,172,109,63
1982,Business,Accountancy,1408,773,635
1982,Business,Accountancy,146,89,57
1983,Business,Accountancy,1392,703,689
1983,Business,Accountancy,137,88,49
2003,Business,Accountancy,859,447,412
2003,Business,Accountancy,20,12,8
2003,Business,Accountancy,98,47,51
2003,Business,Accountancy,84,41,43
2003,Business,Accountancy,54,22,32
2003,Business,Accountancy,33,22,11
2003,Business,Accountancy,83,39,44
1980,Business,Accountancy,1383,842,541
1980,Business,Accountancy,146,86,60
1984,Business,Accountancy,1207,578,629
1984,Business,Accountancy,108,70,38
1985,Business,Accountancy,1082,503,579
1985,Business,Accountancy,130,83,47
1986,Business,Accountancy,942,435,507
1986,Business,Accountancy,139,85,54
1987,Business,Accountancy,904,430,474
1987,Business,Accountancy,135,74,61
1988,Business,Accountancy,1019,491,528
1988,Business,Accountancy,117,63,54
1989,Business,Accountancy,976,484,492
1989,Business,Accountancy,109,60,49
1990,Business,Accountancy,1087,553,534
1990,Business,Accountancy,93,60,33
1991,Business,Accountancy,1138,563,575
1991,Business,Accountancy,115,63,52
1992,Business,Accountancy,1136,573,563
1992,Business,Accountancy,147,87,60
1993,Business,Accountancy,1134,588,546
1993,Business,Accountancy,125,80,45
1994,Business,Accountancy,1041,525,516
1994,Business,Accountancy,109,47,62
1995,Business,Accountancy,1027,525,502
1995,Business,Accountancy,107,56,51
1996,Business,Accountancy,977,501,476
1996,Business,Accountancy,116,50,66
1997,Business,Accountancy,893,456,437
1997,Business,Accountancy,31,18,13
1998,Business,Accountancy,855,430,425
1998,Business,Accountancy,16,11,5
1999,Business,Accountancy,790,399,391
1999,Business,Accountancy,22,13,9
2000,Business,Accountancy,719,347,372
2000,Business,Accountancy,16,10,6
2001,Business,Accountancy,664,313,351
2001,Business,Accountancy,18,11,7
2002,Business,Accountancy,796,401,395
2002,Business,Accountancy,20,13,7
1997,Business,Accountancy,34,18,16
1998,Business,Accountancy,54,31,23
1999,Business,Accountancy,48,27,21
2000,Business,Accountancy,75,45,30
2001,Business,Accountancy,78,42,36
2002,Business,Accountancy,85,46,39
1997,Business,Accountancy,23,15,8
1998,Business,Accountancy,19,9,10
1999,Business,Accountancy,10,5,5
2000,Business,Accountancy,28,15,13
2001,Business,Accountancy,117,59,58
2002,Business,Accountancy,90,45,45
1997,Business,Accountancy,15,4,11
1998,Business,Accountancy,8,2,6
1999,Business,Accountancy,17,10,7
2000,Business,Accountancy,9,6,3
2001,Business,Accountancy,28,15,13
2002,Business,Accountancy,42,23,19
2001,Business,Accountancy,4,1,3
2002,Business,Accountancy,16,9,7
2001,Business,Accountancy,92,46,46
2002,Business,Accountancy,90,36,54
2001,LAS,Actuarial Science,14,10,4
2002,LAS,Actuarial Science,21,9,12
2003,LAS,Actuarial Science,19,5,14
1980,Media,Advertising,44,24,20
1980,Media,Advertising,196,53,143
1981,Media,Advertising,37,20,17
1981,Media,Advertising,197,49,148
1982,Media,Advertising,42,20,22
1982,Media,Advertising,206,58,148
1983,Media,Advertising,46,18,28
1983,Media,Advertising,207,61,146
1984,Media,Advertising,46,14,32
1984,Media,Advertising,211,64,147
1985,Media,Advertising,37,18,19
1985,Media,Advertising,213,61,152
1986,Media,Advertising,39,20,19
1986,Media,Advertising,217,55,162
1987,Media,Advertising,45,24,21
1987,Media,Advertising,221,47,174
1988,Media,Advertising,50,21,29
1988,Media,Advertising,212,46,166
1989,Media,Advertising,48,16,32
1989,Media,Advertising,214,51,163
1990,Media,Advertising,40,17,23
1990,Media,Advertising,214,57,157
1991,Media,Advertising,35,15,20
1991,Media,Advertising,235,61,174
1992,Media,Advertising,38,10,28
1992,Media,Advertising,199,65,134
1993,Media,Advertising,28,7,21
1993,Media,Advertising,207,68,139
1994,Media,Advertising,34,10,24
1994,Media,Advertising,225,73,152
1995,Media,Advertising,30,10,20
1995,Media,Advertising,194,69,125
1996,Media,Advertising,37,14,23
1996,Media,Advertising,198,91,107
1997,Media,Advertising,41,18,23
1997,Media,Advertising,232,95,137
1998,Media,Advertising,239,77,162
1998,Media,Advertising,36,14,22
1999,Media,Advertising,26,12,14
1999,Media,Advertising,265,89,176
2000,Media,Advertising,29,11,18
2000,Media,Advertising,265,76,189
2001,Media,Advertising,22,6,16
2001,Media,Advertising,290,73,217
2002,Media,Advertising,28,9,19
2002,Media,Advertising,283,64,219
2003,Media,Advertising,35,13,22
2003,Media,Advertising,278,66,212
1980,Engineering,Aero & Astro Engineering,330,308,22
1980,Engineering,Aero & Astro Engineering,15,10,5
1980,Engineering,Aero & Astro Engineering,31,30,1
1981,Engineering,Aero & Astro Engineering,380,356,24
1981,Engineering,Aero & Astro Engineering,14,11,3
1981,Engineering,Aero & Astro Engineering,41,38,3
1982,Engineering,Aero & Astro Engineering,408,377,31
1982,Engineering,Aero & Astro Engineering,3,1,2
1982,Engineering,Aero & Astro Engineering,19,16,3
1982,Engineering,Aero & Astro Engineering,51,49,2
1983,Engineering,Aero & Astro Engineering,410,367,43
1983,Engineering,Aero & Astro Engineering,16,15,1
1983,Engineering,Aero & Astro Engineering,47,46,1
1984,Engineering,Aero & Astro Engineering,450,400,50
1985,Engineering,Aero & Astro Engineering,571,515,56
1985,Engineering,Aero & Astro Engineering,6,3,3
1985,Engineering,Aero & Astro Engineering,29,27,2
1986,Engineering,Aero & Astro Engineering,520,469,51
1986,Engineering,Aero & Astro Engineering,11,8,3
1986,Engineering,Aero & Astro Engineering,17,16,1
1986,Engineering,Aero & Astro Engineering,51,47,4
1987,Engineering,Aero & Astro Engineering,558,502,56
1987,Engineering,Aero & Astro Engineering,14,13,1
1987,Engineering,Aero & Astro Engineering,67,64,3
1988,Engineering,Aero & Astro Engineering,494,443,51
1988,Engineering,Aero & Astro Engineering,16,14,2
1988,Engineering,Aero & Astro Engineering,79,74,5
1989,Engineering,Aero & Astro Engineering,403,359,44
1989,Engineering,Aero & Astro Engineering,14,11,3
1989,Engineering,Aero & Astro Engineering,27,25,2
1989,Engineering,Aero & Astro Engineering,69,65,4
1990,Engineering,Aero & Astro Engineering,382,342,40
1990,Engineering,Aero & Astro Engineering,5,4,1
1990,Engineering,Aero & Astro Engineering,24,21,3
1990,Engineering,Aero & Astro Engineering,68,63,5
1991,Engineering,Aero & Astro Engineering,333,297,36
1991,Engineering,Aero & Astro Engineering,5,4,1
1991,Engineering,Aero & Astro Engineering,26,22,4
1991,Engineering,Aero & Astro Engineering,78,74,4
1992,Engineering,Aero & Astro Engineering,291,255,36
1992,Engineering,Aero & Astro Engineering,28,23,5
1992,Engineering,Aero & Astro Engineering,69,65,4
1993,Engineering,Aero & Astro Engineering,280,244,36
1993,Engineering,Aero & Astro Engineering,20,16,4
1993,Engineering,Aero & Astro Engineering,64,60,4
1994,Engineering,Aero & Astro Engineering,249,214,35
1994,Engineering,Aero & Astro Engineering,10,8,2
1994,Engineering,Aero & Astro Engineering,61,58,3
1995,Engineering,Aero & Astro Engineering,217,189,28
1995,Engineering,Aero & Astro Engineering,10,8,2
1995,Engineering,Aero & Astro Engineering,58,54,4
1996,Engineering,Aero & Astro Engineering,194,155,39
1996,Engineering,Aero & Astro Engineering,10,7,3
1996,Engineering,Aero & Astro Engineering,54,50,4
1997,Engineering,Aero & Astro Engineering,212,169,43
1997,Engineering,Aero & Astro Engineering,6,3,3
1997,Engineering,Aero & Astro Engineering,61,53,8
1998,Engineering,Aero & Astro Engineering,223,175,48
1998,Engineering,Aero & Astro Engineering,7,3,4
1998,Engineering,Aero & Astro Engineering,69,60,9
1999,Engineering,Aero & Astro Engineering,267,203,64
1999,Engineering,Aero & Astro Engineering,7,2,5
1999,Engineering,Aero & Astro Engineering,69,64,5
2000,Engineering,Aero & Astro Engineering,302,242,60
2000,Engineering,Aero & Astro Engineering,3,2,1
2000,Engineering,Aero & Astro Engineering,11,6,5
2000,Engineering,Aero & Astro Engineering,62,57,5
2001,Engineering,Aero & Astro Engineering,331,279,52
2001,Engineering,Aero & Astro Engineering,2,1,1
2001,Engineering,Aero & Astro Engineering,10,6,4
2001,Engineering,Aero & Astro Engineering,69,58,11
2002,Engineering,Aero & Astro Engineering,337,277,60
2002,Engineering,Aero & Astro Engineering,2,1,1
2002,Engineering,Aero & Astro Engineering,10,5,5
2002,Engineering,Aero & Astro Engineering,79,66,13
2003,Engineering,Aero & Astro Engineering,329,267,62
2003,Engineering,Aero & Astro Engineering,4,2,2
2003,Engineering,Aero & Astro Engineering,82,72,10
2006,Engineering,Aero & Astro Engineering,1,1,0
2006,Engineering,Aero & Astro Engineering,3,3,0
2006,Engineering,Aero & Astro Engineering,20,17,3
2005,Engineering,Aero & Astro Engineering,25,24,1
2005,Engineering,Aero & Astro Engineering,23,18,5
2004,Engineering,Aero & Astro Engineering,361,298,63
2004,Engineering,Aero & Astro Engineering,45,39,5
2004,Engineering,Aero & Astro Engineering,27,22,5
2018,Engineering,Aerospace Engineering,519,440,79
2018,Engineering,Aerospace Engineering,70,58,12
2018,Engineering,Aerospace Engineering,25,20,5
2018,Engineering,Aerospace Engineering,2,2,0
2018,Engineering,Aerospace Engineering,1,1,0
2018,Engineering,Aerospace Engineering,66,57,9
2018,Engineering,Aerospace Engineering,3,3,0
2017,Engineering,Aerospace Engineering,518,438,80
2017,Engineering,Aerospace Engineering,97,86,11
2017,Engineering,Aerospace Engineering,29,26,3
2017,Engineering,Aerospace Engineering,2,1,1
2017,Engineering,Aerospace Engineering,1,1,0
2017,Engineering,Aerospace Engineering,66,57,9
2017,Engineering,Aerospace Engineering,3,3,0
2016,Engineering,Aerospace Engineering,502,433,69
2016,Engineering,Aerospace Engineering,98,85,13
2016,Engineering,Aerospace Engineering,1,1,0
2016,Engineering,Aerospace Engineering,1,0,1
2016,Engineering,Aerospace Engineering,69,63,6
2016,Engineering,Aerospace Engineering,1,1,0
2015,Engineering,Aerospace Engineering,2,2,0
2015,Engineering,Aerospace Engineering,60,56,4
2015,Engineering,Aerospace Engineering,82,68,14
2015,Engineering,Aerospace Engineering,513,462,51
2014,Engineering,Aerospace Engineering,1,0,1
2014,Engineering,Aerospace Engineering,51,48,3
2014,Engineering,Aerospace Engineering,78,65,13
2014,Engineering,Aerospace Engineering,478,434,44
2013,Engineering,Aerospace Engineering,66,52,14
2013,Engineering,Aerospace Engineering,2,1,1
2013,Engineering,Aerospace Engineering,58,54,4
2013,Engineering,Aerospace Engineering,410,369,41
2012,Engineering,Aerospace Engineering,1,0,1
2012,Engineering,Aerospace Engineering,66,52,14
2012,Engineering,Aerospace Engineering,66,62,4
2012,Engineering,Aerospace Engineering,356,305,51
2011,Engineering,Aerospace Engineering,78,62,16
2011,Engineering,Aerospace Engineering,3,3,0
2011,Engineering,Aerospace Engineering,60,56,4
2011,Engineering,Aerospace Engineering,366,316,50
2010,Engineering,Aerospace Engineering,94,78,16
2010,Engineering,Aerospace Engineering,56,53,3
2010,Engineering,Aerospace Engineering,376,325,51
2009,Engineering,Aerospace Engineering,52,49,3
2009,Engineering,Aerospace Engineering,73,64,9
2009,Engineering,Aerospace Engineering,382,330,52
2008,Engineering,Aerospace Engineering,1,1,0
2008,Engineering,Aerospace Engineering,54,46,7
2008,Engineering,Aerospace Engineering,41,37,4
2008,Engineering,Aerospace Engineering,418,369,49
2007,Engineering,Aerospace Engineering,31,27,4
2007,Engineering,Aerospace Engineering,55,50,5
2007,Engineering,Aerospace Engineering,396,347,49
2006,Engineering,Aerospace Engineering,15,14,1
2006,Engineering,Aerospace Engineering,43,39,4
2006,Engineering,Aerospace Engineering,368,319,49
2005,Engineering,Aerospace Engineering,1,1,0
2005,Engineering,Aerospace Engineering,7,6,1
2005,Engineering,Aerospace Engineering,24,22,2
2005,Engineering,Aerospace Engineering,349,297,52
1992,LAS,African American Studies,3,2,1
1993,LAS,African American Studies,10,6,4
1994,LAS,African American Studies,10,7,3
1995,LAS,African American Studies,9,7,2
1996,LAS,African American Studies,6,5,1
1997,LAS,African American Studies,8,6,2
1998,LAS,African American Studies,10,5,5
1999,LAS,African American Studies,13,6,7
2000,LAS,African American Studies,11,6,5
2001,LAS,African American Studies,7,3,4
2002,LAS,African American Studies,8,2,6
2003,LAS,African American Studies,5,3,2
2018,LAS,African Studies,4,1,3
2017,LAS,African Studies,3,0,3
2016,LAS,African Studies,4,0,4
2015,LAS,African Studies,3,0,3
2014,LAS,African Studies,3,0,3
2013,LAS,African Studies,3,1,2
2012,LAS,African Studies,4,3,1
2011,LAS,African Studies,6,5,1
2010,LAS,African Studies,12,8,4
2009,LAS,African Studies,8,3,5
2008,LAS,African Studies,11,2,9
2007,LAS,African Studies,11,4,7
2006,LAS,African Studies,9,5,4
2005,LAS,African Studies,11,4,7
2004,LAS,African Studies,10,4,6
1997,ACES,Agr & Consumer Economics,34,23,11
1998,ACES,Agr & Consumer Economics,52,28,24
1999,ACES,Agr & Consumer Economics,46,23,23
2000,ACES,Agr & Consumer Economics,41,20,21
2001,ACES,Agr & Consumer Economics,40,21,19
2002,ACES,Agr & Consumer Economics,46,25,21
2003,ACES,Agr & Consumer Economics,53,23,30
1997,ACES,Agr & Consumer Economics,53,37,16
1998,ACES,Agr & Consumer Economics,63,39,24
1999,ACES,Agr & Consumer Economics,79,56,23
2000,ACES,Agr & Consumer Economics,82,61,21
2001,ACES,Agr & Consumer Economics,73,59,14
2002,ACES,Agr & Consumer Economics,83,72,11
2003,ACES,Agr & Consumer Economics,78,67,11
1997,ACES,Agr & Consumer Economics,39,36,3
1998,ACES,Agr & Consumer Economics,50,45,5
1999,ACES,Agr & Consumer Economics,66,57,9
2000,ACES,Agr & Consumer Economics,63,55,8
2001,ACES,Agr & Consumer Economics,58,54,4
2002,ACES,Agr & Consumer Economics,48,44,4
2003,ACES,Agr & Consumer Economics,47,43,4
1997,ACES,Agr & Consumer Economics,55,34,21
1998,ACES,Agr & Consumer Economics,60,39,21
1999,ACES,Agr & Consumer Economics,74,45,29
2000,ACES,Agr & Consumer Economics,65,40,25
2001,ACES,Agr & Consumer Economics,80,46,34
2002,ACES,Agr & Consumer Economics,101,63,38
2003,ACES,Agr & Consumer Economics,98,67,31
1998,ACES,Agr & Consumer Economics,34,18,16
1999,ACES,Agr & Consumer Economics,52,23,29
2000,ACES,Agr & Consumer Economics,64,35,29
2001,ACES,Agr & Consumer Economics,75,43,32
2002,ACES,Agr & Consumer Economics,74,39,35
2003,ACES,Agr & Consumer Economics,84,44,40
2018,ACES,Agr & Consumer Economics,54,29,25
2018,ACES,Agr & Consumer Economics,14,13,1
2018,ACES,Agr & Consumer Economics,142,108,34
2018,ACES,Agr & Consumer Economics,1,0,1
2018,ACES,Agr & Consumer Economics,125,96,29
2018,ACES,Agr & Consumer Economics,35,16,19
2018,ACES,Agr & Consumer Economics,1,0,1
2018,ACES,Agr & Consumer Economics,29,15,14
2018,ACES,Agr & Consumer Economics,75,44,31
2018,ACES,Agr & Consumer Economics,1,1,0
2018,ACES,Agr & Consumer Economics,95,71,24
2018,ACES,Agr & Consumer Economics,75,59,16
2017,ACES,Agr & Consumer Economics,60,33,27
2017,ACES,Agr & Consumer Economics,16,15,1
2017,ACES,Agr & Consumer Economics,144,104,40
2017,ACES,Agr & Consumer Economics,1,0,1
2017,ACES,Agr & Consumer Economics,112,91,21
2017,ACES,Agr & Consumer Economics,37,21,16
2017,ACES,Agr & Consumer Economics,46,25,21
2017,ACES,Agr & Consumer Economics,73,41,32
2017,ACES,Agr & Consumer Economics,81,56,25
2017,ACES,Agr & Consumer Economics,72,54,18
2016,ACES,Agr & Consumer Economics,58,29,29
2016,ACES,Agr & Consumer Economics,26,23,3
2016,ACES,Agr & Consumer Economics,162,115,47
2016,ACES,Agr & Consumer Economics,105,88,17
2016,ACES,Agr & Consumer Economics,33,16,17
2016,ACES,Agr & Consumer Economics,49,29,20
2016,ACES,Agr & Consumer Economics,77,40,37
2016,ACES,Agr & Consumer Economics,1,1,0
2016,ACES,Agr & Consumer Economics,97,67,30
2016,ACES,Agr & Consumer Economics,67,56,11
2015,ACES,Agr & Consumer Economics,25,22,3
2015,ACES,Agr & Consumer Economics,1,0,1
2015,ACES,Agr & Consumer Economics,24,10,14
2015,ACES,Agr & Consumer Economics,65,36,29
2015,ACES,Agr & Consumer Economics,73,52,21
2015,ACES,Agr & Consumer Economics,63,31,32
2015,ACES,Agr & Consumer Economics,98,74,24
2015,ACES,Agr & Consumer Economics,94,65,29
2015,ACES,Agr & Consumer Economics,53,28,25
2015,ACES,Agr & Consumer Economics,174,127,47
2014,ACES,Agr & Consumer Economics,1,0,1
2014,ACES,Agr & Consumer Economics,1,0,1
2014,ACES,Agr & Consumer Economics,22,19,3
2014,ACES,Agr & Consumer Economics,1,0,1
2014,ACES,Agr & Consumer Economics,64,39,25
2014,ACES,Agr & Consumer Economics,72,53,19
2014,ACES,Agr & Consumer Economics,38,22,16
2014,ACES,Agr & Consumer Economics,53,23,30
2014,ACES,Agr & Consumer Economics,90,60,30
2014,ACES,Agr & Consumer Economics,59,33,26
2014,ACES,Agr & Consumer Economics,116,88,28
2014,ACES,Agr & Consumer Economics,168,120,48
2013,ACES,Agr & Consumer Economics,2,1,1
2013,ACES,Agr & Consumer Economics,23,21,2
2013,ACES,Agr & Consumer Economics,33,22,11
2013,ACES,Agr & Consumer Economics,1,0,1
2013,ACES,Agr & Consumer Economics,1,1,0
2013,ACES,Agr & Consumer Economics,5,3,2
2013,ACES,Agr & Consumer Economics,151,109,42
2013,ACES,Agr & Consumer Economics,46,26,20
2013,ACES,Agr & Consumer Economics,91,60,31
2013,ACES,Agr & Consumer Economics,76,54,22
2013,ACES,Agr & Consumer Economics,121,92,29
2013,ACES,Agr & Consumer Economics,81,47,34
2013,ACES,Agr & Consumer Economics,63,28,35
2012,ACES,Agr & Consumer Economics,9,6,3
2012,ACES,Agr & Consumer Economics,21,19,2
2012,ACES,Agr & Consumer Economics,4,3,1
2012,ACES,Agr & Consumer Economics,9,5,4
2012,ACES,Agr & Consumer Economics,28,20,8
2012,ACES,Agr & Consumer Economics,42,21,21
2012,ACES,Agr & Consumer Economics,69,52,17
2012,ACES,Agr & Consumer Economics,93,50,43
2012,ACES,Agr & Consumer Economics,142,107,35
2012,ACES,Agr & Consumer Economics,107,79,28
2012,ACES,Agr & Consumer Economics,43,20,23
2012,ACES,Agr & Consumer Economics,77,44,33
2011,ACES,Agr & Consumer Economics,20,19,1
2011,ACES,Agr & Consumer Economics,30,21,9
2011,ACES,Agr & Consumer Economics,14,8,6
2011,ACES,Agr & Consumer Economics,76,63,13
2011,ACES,Agr & Consumer Economics,19,12,7
2011,ACES,Agr & Consumer Economics,73,56,17
2011,ACES,Agr & Consumer Economics,42,22,20
2011,ACES,Agr & Consumer Economics,67,39,28
2011,ACES,Agr & Consumer Economics,129,96,33
2011,ACES,Agr & Consumer Economics,39,19,20
2011,ACES,Agr & Consumer Economics,92,47,45
2010,ACES,Agr & Consumer Economics,29,27,2
2010,ACES,Agr & Consumer Economics,29,22,7
2010,ACES,Agr & Consumer Economics,32,18,14
2010,ACES,Agr & Consumer Economics,52,35,17
2010,ACES,Agr & Consumer Economics,39,24,15
2010,ACES,Agr & Consumer Economics,80,57,23
2010,ACES,Agr & Consumer Economics,54,37,17
2010,ACES,Agr & Consumer Economics,48,28,20
2010,ACES,Agr & Consumer Economics,133,97,36
2010,ACES,Agr & Consumer Economics,46,22,24
2010,ACES,Agr & Consumer Economics,70,35,35
2009,ACES,Agr & Consumer Economics,34,32,2
2009,ACES,Agr & Consumer Economics,31,20,11
2009,ACES,Agr & Consumer Economics,52,28,24
2009,ACES,Agr & Consumer Economics,63,35,28
2009,ACES,Agr & Consumer Economics,63,37,26
2009,ACES,Agr & Consumer Economics,144,102,42
2009,ACES,Agr & Consumer Economics,33,23,10
2009,ACES,Agr & Consumer Economics,92,66,26
2009,ACES,Agr & Consumer Economics,57,43,14
2009,ACES,Agr & Consumer Economics,27,11,16
2009,ACES,Agr & Consumer Economics,50,28,22
2008,ACES,Agr & Consumer Economics,1,1,0
2008,ACES,Agr & Consumer Economics,27,25,2
2008,ACES,Agr & Consumer Economics,58,36,22
2008,ACES,Agr & Consumer Economics,26,16,10
2008,ACES,Agr & Consumer Economics,25,15,10
2008,ACES,Agr & Consumer Economics,45,25,20
2008,ACES,Agr & Consumer Economics,48,39,9
2008,ACES,Agr & Consumer Economics,103,66,37
2008,ACES,Agr & Consumer Economics,167,108,59
2008,ACES,Agr & Consumer Economics,125,92,32
2008,ACES,Agr & Consumer Economics,28,14,14
2008,ACES,Agr & Consumer Economics,46,26,20
2007,ACES,Agr & Consumer Economics,19,17,2
2007,ACES,Agr & Consumer Economics,17,12,5
2007,ACES,Agr & Consumer Economics,40,26,14
2007,ACES,Agr & Consumer Economics,56,32,24
2007,ACES,Agr & Consumer Economics,123,84,39
2007,ACES,Agr & Consumer Economics,21,15,6
2007,ACES,Agr & Consumer Economics,91,64,27
2007,ACES,Agr & Consumer Economics,136,90,46
2007,ACES,Agr & Consumer Economics,21,14,7
2007,ACES,Agr & Consumer Economics,46,25,21
2006,ACES,Agr & Consumer Economics,27,16,11
2006,ACES,Agr & Consumer Economics,15,13,2
2006,ACES,Agr & Consumer Economics,17,9,8
2006,ACES,Agr & Consumer Economics,1,1,0
2006,ACES,Agr & Consumer Economics,42,26,16
2006,ACES,Agr & Consumer Economics,55,36,19
2006,ACES,Agr & Consumer Economics,69,41,28
2006,ACES,Agr & Consumer Economics,24,12,12
2006,ACES,Agr & Consumer Economics,26,18,8
2006,ACES,Agr & Consumer Economics,60,36,24
2005,ACES,Agr & Consumer Economics,28,16,12
2005,ACES,Agr & Consumer Economics,55,33,22
2004,ACES,Agr & Consumer Economics,30,18,12
2004,ACES,Agr & Consumer Economics,55,32,23
1997,ACES,Agr & Environmental Cmc & Educ,27,6,21
1998,ACES,Agr & Environmental Cmc & Educ,48,11,37
1999,ACES,Agr & Environmental Cmc & Educ,58,17,41
2000,ACES,Agr & Environmental Cmc & Educ,60,16,44
2001,ACES,Agr & Environmental Cmc & Educ,65,19,46
2002,ACES,Agr & Environmental Cmc & Educ,81,26,55
2003,ACES,Agr & Environmental Cmc & Educ,73,22,51
1997,ACES,Agr & Environmental Cmc & Educ,9,3,6
1998,ACES,Agr & Environmental Cmc & Educ,12,4,8
1999,ACES,Agr & Environmental Cmc & Educ,16,5,11
2000,ACES,Agr & Environmental Cmc & Educ,13,5,8
2001,ACES,Agr & Environmental Cmc & Educ,13,6,7
2002,ACES,Agr & Environmental Cmc & Educ,13,4,9
2003,ACES,Agr & Environmental Cmc & Educ,10,5,5
1998,ACES,Agr & Environmental Cmc & Educ,8,1,7
1999,ACES,Agr & Environmental Cmc & Educ,8,1,7
2000,ACES,Agr & Environmental Cmc & Educ,12,4,8
2001,ACES,Agr & Environmental Cmc & Educ,8,3,5
2002,ACES,Agr & Environmental Cmc & Educ,10,1,9
2003,ACES,Agr & Environmental Cmc & Educ,12,2,10
1997,ACES,Agr & Environmental Cmc & Educ,24,12,12
1998,ACES,Agr & Environmental Cmc & Educ,38,20,18
1999,ACES,Agr & Environmental Cmc & Educ,36,18,18
2000,ACES,Agr & Environmental Cmc & Educ,31,13,18
2001,ACES,Agr & Environmental Cmc & Educ,34,18,16
2002,ACES,Agr & Environmental Cmc & Educ,38,20,18
2003,ACES,Agr & Environmental Cmc & Educ,34,15,19
1980,ACES,Agr & Environmental Cmc & Educ,5,4,1
1981,ACES,Agr & Environmental Cmc & Educ,5,4,1
1984,ACES,Agr & Environmental Cmc & Educ,5,3,2
1986,ACES,Agr & Environmental Cmc & Educ,6,4,2
1987,ACES,Agr & Environmental Cmc & Educ,5,2,3
1988,ACES,Agr & Environmental Cmc & Educ,4,3,1
1989,ACES,Agr & Environmental Cmc & Educ,3,1,2
1990,ACES,Agr & Environmental Cmc & Educ,7,4,3
1991,ACES,Agr & Environmental Cmc & Educ,7,1,6
1992,ACES,Agr & Environmental Cmc & Educ,5,2,3
1993,ACES,Agr & Environmental Cmc & Educ,8,5,3
1994,ACES,Agr & Environmental Cmc & Educ,5,4,1
1995,ACES,Agr & Environmental Cmc & Educ,10,6,4
1996,ACES,Agr & Environmental Cmc & Educ,9,5,4
1998,ACES,Agr & Environmental Cmc & Educ,8,1,7
1999,ACES,Agr & Environmental Cmc & Educ,9,4,5
2000,ACES,Agr & Environmental Cmc & Educ,9,3,6
2001,ACES,Agr & Environmental Cmc & Educ,13,3,10
2002,ACES,Agr & Environmental Cmc & Educ,12,1,11
2003,ACES,Agr & Environmental Cmc & Educ,7,2,5
2014,ACES,Agr & Environmental Cmc & Educ,3,0,3
2013,ACES,Agr & Environmental Cmc & Educ,11,2,9
2012,ACES,Agr & Environmental Cmc & Educ,19,4,15
2011,ACES,Agr & Environmental Cmc & Educ,22,7,15
2011,ACES,Agr & Environmental Cmc & Educ,18,6,12
2011,ACES,Agr & Environmental Cmc & Educ,38,6,32
2010,ACES,Agr & Environmental Cmc & Educ,26,7,19
2010,ACES,Agr & Environmental Cmc & Educ,14,6,8
2010,ACES,Agr & Environmental Cmc & Educ,50,13,37
2009,ACES,Agr & Environmental Cmc & Educ,1,1,0
2009,ACES,Agr & Environmental Cmc & Educ,6,1,5
2009,ACES,Agr & Environmental Cmc & Educ,22,4,18
2009,ACES,Agr & Environmental Cmc & Educ,53,12,41
2008,ACES,Agr & Environmental Cmc & Educ,5,1,4
2008,ACES,Agr & Environmental Cmc & Educ,4,0,4
2008,ACES,Agr & Environmental Cmc & Educ,20,5,15
2008,ACES,Agr & Environmental Cmc & Educ,44,9,35
2007,ACES,Agr & Environmental Cmc & Educ,10,2,8
2007,ACES,Agr & Environmental Cmc & Educ,6,0,6
2007,ACES,Agr & Environmental Cmc & Educ,51,11,40
2007,ACES,Agr & Environmental Cmc & Educ,23,8,15
2006,ACES,Agr & Environmental Cmc & Educ,34,9,25
2006,ACES,Agr & Environmental Cmc & Educ,2,0,2
2006,ACES,Agr & Environmental Cmc & Educ,8,2,6
2006,ACES,Agr & Environmental Cmc & Educ,23,8,15
2006,ACES,Agr & Environmental Cmc & Educ,31,5,26
2005,ACES,Agr & Environmental Cmc & Educ,9,3,6
2005,ACES,Agr & Environmental Cmc & Educ,11,5,6
2005,ACES,Agr & Environmental Cmc & Educ,31,12,19
2005,ACES,Agr & Environmental Cmc & Educ,52,10,42
2004,ACES,Agr & Environmental Cmc & Educ,60,16,44
2004,ACES,Agr & Environmental Cmc & Educ,8,3,5
2004,ACES,Agr & Environmental Cmc & Educ,8,3,5
2004,ACES,Agr & Environmental Cmc & Educ,36,15,21
1997,ACES,Agr Engineering & Agr Science,45,31,14
1998,ACES,Agr Engineering & Agr Science,58,45,13
1999,ACES,Agr Engineering & Agr Science,59,51,8
2000,ACES,Agr Engineering & Agr Science,49,43,6
2001,ACES,Agr Engineering & Agr Science,51,47,4
2002,ACES,Agr Engineering & Agr Science,43,40,3
2003,ACES,Agr Engineering & Agr Science,40,36,4
2015,ACES,Agr Engineering & Agr Science,1,1,0
2014,ACES,Agr Engineering & Agr Science,1,1,0
2012,ACES,Agr Engineering & Agr Science,4,3,1
2011,ACES,Agr Engineering & Agr Science,21,18,3
2010,ACES,Agr Engineering & Agr Science,41,35,6
2009,ACES,Agr Engineering & Agr Science,69,60,9
2008,ACES,Agr Engineering & Agr Science,54,47,7
2007,ACES,Agr Engineering & Agr Science,44,38,6
2006,ACES,Agr Engineering & Agr Science,42,38,4
2005,ACES,Agr Engineering & Agr Science,37,34,3
2004,ACES,Agr Engineering & Agr Science,45,39,6
2009,ACES,"Agribusiness, Farm & Financial ",2,1,1
2009,ACES,"Agribusiness, Farm & Financial ",2,2,0
2008,ACES,"Agribusiness, Farm & Financial ",10,6,4
2008,ACES,"Agribusiness, Farm & Financial ",4,4,0
2008,ACES,"Agribusiness, Farm & Financial ",13,12,1
2008,ACES,"Agribusiness, Farm & Financial ",4,4,0
2007,ACES,"Agribusiness, Farm & Financial ",27,18,9
2007,ACES,"Agribusiness, Farm & Financial ",14,14,0
2007,ACES,"Agribusiness, Farm & Financial ",43,34,8
2007,ACES,"Agribusiness, Farm & Financial ",16,13,3
2006,ACES,"Agribusiness, Farm & Financial ",58,39,19
2006,ACES,"Agribusiness, Farm & Financial ",21,21,0
2006,ACES,"Agribusiness, Farm & Financial ",77,58,18
2006,ACES,"Agribusiness, Farm & Financial ",52,40,12
2005,ACES,"Agribusiness, Farm & Financial ",40,36,3
2005,ACES,"Agribusiness, Farm & Financial ",82,49,33
2005,ACES,"Agribusiness, Farm & Financial ",128,97,30
2005,ACES,"Agribusiness, Farm & Financial ",67,50,17
2004,ACES,"Agribusiness, Farm & Financial ",76,39,37
2004,ACES,"Agribusiness, Farm & Financial ",67,51,16
2004,ACES,"Agribusiness, Farm & Financial ",45,42,2
2004,ACES,"Agribusiness, Farm & Financial ",98,65,32
2018,ACES,Agric Leadership & Sci Educ,27,8,19
2018,ACES,Agric Leadership & Sci Educ,28,9,19
2017,ACES,Agric Leadership & Sci Educ,32,8,24
2017,ACES,Agric Leadership & Sci Educ,42,18,24
2016,ACES,Agric Leadership & Sci Educ,33,11,22
2016,ACES,Agric Leadership & Sci Educ,43,14,29
2015,ACES,Agric Leadership & Sci Educ,24,8,16
2015,ACES,Agric Leadership & Sci Educ,31,13,18
2014,ACES,Agric Leadership & Sci Educ,26,9,17
2014,ACES,Agric Leadership & Sci Educ,29,13,16
2013,ACES,Agric Leadership & Sci Educ,25,9,16
2013,ACES,Agric Leadership & Sci Educ,33,15,18
2012,ACES,Agric Leadership & Sci Educ,18,8,10
2012,ACES,Agric Leadership & Sci Educ,25,14,11
1980,ACES,Agricultural & Applied Econ,242,216,26
1980,ACES,Agricultural & Applied Econ,72,60,12
1981,ACES,Agricultural & Applied Econ,275,234,41
1981,ACES,Agricultural & Applied Econ,73,54,19
1982,ACES,Agricultural & Applied Econ,317,271,46
1982,ACES,Agricultural & Applied Econ,69,51,18
1983,ACES,Agricultural & Applied Econ,339,283,56
1983,ACES,Agricultural & Applied Econ,89,72,17
1984,ACES,Agricultural & Applied Econ,350,293,57
1984,ACES,Agricultural & Applied Econ,7,6,1
1984,ACES,Agricultural & Applied Econ,87,68,19
1985,ACES,Agricultural & Applied Econ,352,297,55
1985,ACES,Agricultural & Applied Econ,7,5,2
1985,ACES,Agricultural & Applied Econ,83,66,17
1986,ACES,Agricultural & Applied Econ,321,277,44
1986,ACES,Agricultural & Applied Econ,8,7,1
1986,ACES,Agricultural & Applied Econ,94,79,15
1987,ACES,Agricultural & Applied Econ,301,260,41
1987,ACES,Agricultural & Applied Econ,91,73,18
1988,ACES,Agricultural & Applied Econ,299,259,40
1988,ACES,Agricultural & Applied Econ,80,68,12
1989,ACES,Agricultural & Applied Econ,341,277,64
1989,ACES,Agricultural & Applied Econ,81,57,24
1990,ACES,Agricultural & Applied Econ,350,290,60
1990,ACES,Agricultural & Applied Econ,88,62,26
1991,ACES,Agricultural & Applied Econ,346,279,67
1991,ACES,Agricultural & Applied Econ,95,72,23
1992,ACES,Agricultural & Applied Econ,308,234,74
1992,ACES,Agricultural & Applied Econ,96,77,19
1993,ACES,Agricultural & Applied Econ,334,254,80
1993,ACES,Agricultural & Applied Econ,104,86,18
1994,ACES,Agricultural & Applied Econ,349,278,71
1994,ACES,Agricultural & Applied Econ,109,89,20
1995,ACES,Agricultural & Applied Econ,347,270,77
1995,ACES,Agricultural & Applied Econ,104,77,27
1996,ACES,Agricultural & Applied Econ,337,246,91
1996,ACES,Agricultural & Applied Econ,112,79,33
1997,ACES,Agricultural & Applied Econ,139,109,30
1997,ACES,Agricultural & Applied Econ,107,76,31
1998,ACES,Agricultural & Applied Econ,63,55,8
1998,ACES,Agricultural & Applied Econ,64,44,20
1999,ACES,Agricultural & Applied Econ,16,15,1
1999,ACES,Agricultural & Applied Econ,38,25,13
2000,ACES,Agricultural & Applied Econ,23,14,9
2001,ACES,Agricultural & Applied Econ,6,3,3
2002,ACES,Agricultural & Applied Econ,4,2,2
2018,ACES,Agricultural & Applied Econ,23,13,10
2018,ACES,Agricultural & Applied Econ,63,35,28
2017,ACES,Agricultural & Applied Econ,20,15,5
2017,ACES,Agricultural & Applied Econ,59,32,27
2016,ACES,Agricultural & Applied Econ,26,18,8
2016,ACES,Agricultural & Applied Econ,56,31,25
2015,ACES,Agricultural & Applied Econ,33,19,14
2015,ACES,Agricultural & Applied Econ,50,28,22
2014,ACES,Agricultural & Applied Econ,28,14,14
2014,ACES,Agricultural & Applied Econ,39,23,16
2013,ACES,Agricultural & Applied Econ,32,19,13
2013,ACES,Agricultural & Applied Econ,25,13,12
2012,ACES,Agricultural & Applied Econ,26,14,12
2012,ACES,Agricultural & Applied Econ,28,11,17
2011,ACES,Agricultural & Applied Econ,15,5,10
2011,ACES,Agricultural & Applied Econ,22,12,10
2018,ACES,Agricultural & Biological Engr,84,47,37
2017,ACES,Agricultural & Biological Engr,77,51,26
2016,ACES,Agricultural & Biological Engr,101,65,36
2015,ACES,Agricultural & Biological Engr,98,64,34
2014,ACES,Agricultural & Biological Engr,100,68,32
2013,ACES,Agricultural & Biological Engr,89,59,30
2012,ACES,Agricultural & Biological Engr,75,56,19
2011,ACES,Agricultural & Biological Engr,38,28,10
2010,ACES,Agricultural & Biological Engr,29,24,5
2018,Engineering,Agricultural & Biological Engr,52,30,22
2018,Engineering,Agricultural & Biological Engr,11,8,3
2018,Engineering,Agricultural & Biological Engr,17,10,7
2018,Engineering,Agricultural & Biological Engr,25,20,5
2018,Engineering,Agricultural & Biological Engr,31,16,15
2018,Engineering,Agricultural & Biological Engr,5,4,1
2017,Engineering,Agricultural & Biological Engr,66,40,26
2017,Engineering,Agricultural & Biological Engr,10,8,2
2017,Engineering,Agricultural & Biological Engr,9,2,7
2017,Engineering,Agricultural & Biological Engr,29,19,10
2017,Engineering,Agricultural & Biological Engr,34,23,11
2017,Engineering,Agricultural & Biological Engr,4,3,1
2016,Engineering,Agricultural & Biological Engr,25,14,11
2016,Engineering,Agricultural & Biological Engr,11,9,2
2016,Engineering,Agricultural & Biological Engr,8,5,3
2016,Engineering,Agricultural & Biological Engr,36,25,11
2016,Engineering,Agricultural & Biological Engr,38,25,13
2016,Engineering,Agricultural & Biological Engr,3,2,1
2015,Engineering,Agricultural & Biological Engr,17,14,3
2015,Engineering,Agricultural & Biological Engr,15,11,4
2015,Engineering,Agricultural & Biological Engr,31,22,9
2015,Engineering,Agricultural & Biological Engr,29,20,9
2015,Engineering,Agricultural & Biological Engr,34,21,13
2014,Engineering,Agricultural & Biological Engr,32,26,6
2014,Engineering,Agricultural & Biological Engr,23,19,4
2014,Engineering,Agricultural & Biological Engr,28,21,7
2014,Engineering,Agricultural & Biological Engr,29,18,11
2014,Engineering,Agricultural & Biological Engr,36,24,12
2013,Engineering,Agricultural & Biological Engr,67,53,14
2013,Engineering,Agricultural & Biological Engr,10,7,3
2013,Engineering,Agricultural & Biological Engr,31,20,11
2013,Engineering,Agricultural & Biological Engr,16,14,2
2013,Engineering,Agricultural & Biological Engr,36,22,14
2012,Engineering,Agricultural & Biological Engr,3,1,2
2012,Engineering,Agricultural & Biological Engr,14,12,2
2012,Engineering,Agricultural & Biological Engr,13,7,6
2012,Engineering,Agricultural & Biological Engr,27,18,9
2012,Engineering,Agricultural & Biological Engr,42,29,13
2012,Engineering,Agricultural & Biological Engr,84,65,19
2011,Engineering,Agricultural & Biological Engr,1,0,1
2011,Engineering,Agricultural & Biological Engr,35,24,11
2011,Engineering,Agricultural & Biological Engr,23,17,6
2011,Engineering,Agricultural & Biological Engr,95,66,29
2011,Engineering,Agricultural & Biological Engr,2,1,1
2010,Engineering,Agricultural & Biological Engr,17,13,4
2010,Engineering,Agricultural & Biological Engr,21,14,7
2010,Engineering,Agricultural & Biological Engr,64,44,20
2009,Engineering,Agricultural & Biological Engr,1,1,0
2009,Engineering,Agricultural & Biological Engr,30,19,11
2009,Engineering,Agricultural & Biological Engr,14,9,5
2009,Engineering,Agricultural & Biological Engr,14,8,6
2008,Engineering,Agricultural & Biological Engr,8,6,2
2008,Engineering,Agricultural & Biological Engr,6,1,5
1980,ACES,Agricultural Communications,78,31,47
1981,ACES,Agricultural Communications,72,21,51
1982,ACES,Agricultural Communications,86,30,56
1983,ACES,Agricultural Communications,84,26,58
1984,ACES,Agricultural Communications,78,27,51
1985,ACES,Agricultural Communications,77,25,52
1986,ACES,Agricultural Communications,74,20,54
1987,ACES,Agricultural Communications,70,20,50
1988,ACES,Agricultural Communications,73,20,53
1989,ACES,Agricultural Communications,78,22,56
1990,ACES,Agricultural Communications,74,23,51
1991,ACES,Agricultural Communications,79,25,54
1992,ACES,Agricultural Communications,85,22,63
1993,ACES,Agricultural Communications,77,21,56
1994,ACES,Agricultural Communications,74,23,51
1995,ACES,Agricultural Communications,88,36,52
1996,ACES,Agricultural Communications,77,27,50
1997,ACES,Agricultural Communications,46,14,32
1998,ACES,Agricultural Communications,19,6,13
1999,ACES,Agricultural Communications,7,2,5
2018,ACES,Agricultural Communications,1,0,1
2018,ACES,Agricultural Communications,27,10,17
2018,ACES,Agricultural Communications,10,1,9
2017,ACES,Agricultural Communications,10,4,6
2017,ACES,Agricultural Communications,11,3,8
2017,ACES,Agricultural Communications,5,1,4
2018,Media,Agricultural Communications,1,0,1
2018,Media,Agricultural Communications,1,1,0
2017,Media,Agricultural Communications,2,0,2
2017,Media,Agricultural Communications,6,3,3
2017,Media,Agricultural Communications,5,1,4
2016,Media,Agricultural Communications,9,1,8
2016,Media,Agricultural Communications,15,5,10
2016,Media,Agricultural Communications,14,2,12
2015,Media,Agricultural Communications,10,1,9
2015,Media,Agricultural Communications,5,1,4
2015,Media,Agricultural Communications,20,6,14
2015,Media,Agricultural Communications,6,0,6
2014,Media,Agricultural Communications,6,1,5
2014,Media,Agricultural Communications,3,0,3
2014,Media,Agricultural Communications,23,7,16
2014,Media,Agricultural Communications,7,0,7
2013,Media,Agricultural Communications,14,5,9
2013,Media,Agricultural Communications,1,0,1
2013,Media,Agricultural Communications,10,0,10
2012,Media,Agricultural Communications,2,0,2
2012,Media,Agricultural Communications,2,0,2
2012,Media,Agricultural Communications,3,1,2
2012,Media,Agricultural Communications,12,3,9
2011,Media,Agricultural Communications,3,0,3
2011,Media,Agricultural Communications,4,0,4
2005,ACES,Agricultural Economics,1,1,0
2004,ACES,Agricultural Economics,1,1,0
1980,ACES,Agricultural Education,26,21,5
1981,ACES,Agricultural Education,20,17,3
1982,ACES,Agricultural Education,25,20,5
1983,ACES,Agricultural Education,26,23,3
1984,ACES,Agricultural Education,14,12,2
1985,ACES,Agricultural Education,15,13,2
1986,ACES,Agricultural Education,15,14,1
1987,ACES,Agricultural Education,13,12,1
1988,ACES,Agricultural Education,14,10,4
1989,ACES,Agricultural Education,10,6,4
1990,ACES,Agricultural Education,10,5,5
1991,ACES,Agricultural Education,14,6,8
1992,ACES,Agricultural Education,12,8,4
1993,ACES,Agricultural Education,16,8,8
1994,ACES,Agricultural Education,20,12,8
1995,ACES,Agricultural Education,19,10,9
1996,ACES,Agricultural Education,37,18,19
1997,ACES,Agricultural Education,12,4,8
2018,ACES,Agricultural Education,10,2,8
2018,ACES,Agricultural Education,22,8,14
2017,ACES,Agricultural Education,8,2,6
2017,ACES,Agricultural Education,26,6,20
2016,ACES,Agricultural Education,11,4,7
2016,ACES,Agricultural Education,2,1,1
2015,ACES,Agricultural Education,10,4,6
2014,ACES,Agricultural Education,3,1,2
2014,ACES,Agricultural Education,5,1,4
2013,ACES,Agricultural Education,7,1,6
2013,ACES,Agricultural Education,1,0,1
2012,ACES,Agricultural Education,5,1,4
2011,ACES,Agricultural Education,8,1,7
2010,ACES,Agricultural Education,6,2,4
2009,ACES,Agricultural Education,2,0,2
2008,ACES,Agricultural Education,1,1,0
2007,ACES,Agricultural Education,3,1,2
2007,ACES,Agricultural Education,1,1,0
2006,ACES,Agricultural Education,3,2,1
2005,ACES,Agricultural Education,7,1,6
2004,ACES,Agricultural Education,10,0,10
1980,ACES,Agricultural Engineering,83,75,8
1981,ACES,Agricultural Engineering,89,82,7
1982,ACES,Agricultural Engineering,109,102,7
1983,ACES,Agricultural Engineering,98,91,7
1984,ACES,Agricultural Engineering,84,80,4
1985,ACES,Agricultural Engineering,74,70,4
1986,ACES,Agricultural Engineering,69,66,3
1987,ACES,Agricultural Engineering,64,58,6
1988,ACES,Agricultural Engineering,57,52,5
1989,ACES,Agricultural Engineering,56,51,5
1990,ACES,Agricultural Engineering,57,50,7
1991,ACES,Agricultural Engineering,74,68,6
1992,ACES,Agricultural Engineering,98,85,13
1993,ACES,Agricultural Engineering,109,95,14
1994,ACES,Agricultural Engineering,97,84,13
1995,ACES,Agricultural Engineering,91,81,10
1996,ACES,Agricultural Engineering,73,65,8
1997,ACES,Agricultural Engineering,28,25,3
1998,ACES,Agricultural Engineering,8,6,2
1999,ACES,Agricultural Engineering,2,1,1
1980,Engineering,Agricultural Engineering,76,64,12
1980,Engineering,Agricultural Engineering,22,21,1
1981,Engineering,Agricultural Engineering,74,63,11
1981,Engineering,Agricultural Engineering,23,22,1
1982,Engineering,Agricultural Engineering,72,64,8
1982,Engineering,Agricultural Engineering,4,3,1
1983,Engineering,Agricultural Engineering,68,63,5
1984,Engineering,Agricultural Engineering,52,47,5
1985,Engineering,Agricultural Engineering,48,43,5
1986,Engineering,Agricultural Engineering,37,35,2
1987,Engineering,Agricultural Engineering,35,33,2
1988,Engineering,Agricultural Engineering,31,30,1
1988,Engineering,Agricultural Engineering,45,42,3
1989,Engineering,Agricultural Engineering,32,30,2
1989,Engineering,Agricultural Engineering,50,46,4
1990,Engineering,Agricultural Engineering,35,28,7
1990,Engineering,Agricultural Engineering,48,45,3
1991,Engineering,Agricultural Engineering,41,29,12
1991,Engineering,Agricultural Engineering,47,43,4
1992,Engineering,Agricultural Engineering,39,30,9
1992,Engineering,Agricultural Engineering,47,40,7
1993,Engineering,Agricultural Engineering,41,31,10
1993,Engineering,Agricultural Engineering,47,34,13
1994,Engineering,Agricultural Engineering,47,34,13
1994,Engineering,Agricultural Engineering,44,32,12
1995,Engineering,Agricultural Engineering,63,51,12
1995,Engineering,Agricultural Engineering,42,28,14
1996,Engineering,Agricultural Engineering,68,60,8
1996,Engineering,Agricultural Engineering,45,31,14
1997,Engineering,Agricultural Engineering,87,73,14
1997,Engineering,Agricultural Engineering,2,1,1
1997,Engineering,Agricultural Engineering,42,30,12
1998,Engineering,Agricultural Engineering,77,64,13
1998,Engineering,Agricultural Engineering,40,28,12
1999,Engineering,Agricultural Engineering,68,52,16
1999,Engineering,Agricultural Engineering,45,31,14
2000,Engineering,Agricultural Engineering,77,58,19
2000,Engineering,Agricultural Engineering,43,29,14
2001,Engineering,Agricultural Engineering,71,58,13
2001,Engineering,Agricultural Engineering,37,29,8
2002,Engineering,Agricultural Engineering,56,46,10
2002,Engineering,Agricultural Engineering,39,28,11
2003,Engineering,Agricultural Engineering,52,49,3
2003,Engineering,Agricultural Engineering,43,30,13
2013,Engineering,Agricultural Engineering,1,1,0
2012,Engineering,Agricultural Engineering,1,1,0
2012,Engineering,Agricultural Engineering,1,1,0
2011,Engineering,Agricultural Engineering,4,2,2
2011,Engineering,Agricultural Engineering,1,1,0
2011,Engineering,Agricultural Engineering,3,3,0
2011,Engineering,Agricultural Engineering,2,1,1
2010,Engineering,Agricultural Engineering,1,1,0
2010,Engineering,Agricultural Engineering,2,2,0
2010,Engineering,Agricultural Engineering,11,11,0
2010,Engineering,Agricultural Engineering,30,23,7
2009,Engineering,Agricultural Engineering,1,1,0
2009,Engineering,Agricultural Engineering,1,1,0
2009,Engineering,Agricultural Engineering,42,34,8
2009,Engineering,Agricultural Engineering,7,6,1
2009,Engineering,Agricultural Engineering,13,13,0
2008,Engineering,Agricultural Engineering,1,1,0
2008,Engineering,Agricultural Engineering,50,41,9
2008,Engineering,Agricultural Engineering,19,15,4
2008,Engineering,Agricultural Engineering,20,19,1
2007,Engineering,Agricultural Engineering,46,39,7
2007,Engineering,Agricultural Engineering,20,17,3
2007,Engineering,Agricultural Engineering,26,22,4
2006,Engineering,Agricultural Engineering,49,40,9
2006,Engineering,Agricultural Engineering,13,10,3
2006,Engineering,Agricultural Engineering,26,22,4
2005,Engineering,Agricultural Engineering,58,50,8
2005,Engineering,Agricultural Engineering,12,9,3
2005,Engineering,Agricultural Engineering,23,18,5
2004,Engineering,Agricultural Engineering,56,50,6
2004,Engineering,Agricultural Engineering,17,11,6
2004,Engineering,Agricultural Engineering,21,16,5
2018,ACES,Agricultural Production,6,1,5
2017,ACES,Agricultural Production,14,2,12
2016,ACES,Agricultural Production,16,3,13
2015,ACES,Agricultural Production,8,2,6
2014,ACES,Agricultural Production,7,2,5
2013,ACES,Agricultural Production,6,2,4
2012,ACES,Agricultural Production,1,1,0
2012,ACES,Agricultural Production,8,4,4
2011,ACES,Agricultural Production,8,4,4
2010,ACES,Agricultural Production,7,3,4
2009,ACES,Agricultural Production,5,2,3
1980,ACES,Agricultural Sciences,81,57,24
1981,ACES,Agricultural Sciences,75,52,23
1982,ACES,Agricultural Sciences,68,50,18
1983,ACES,Agricultural Sciences,77,50,27
1984,ACES,Agricultural Sciences,66,43,23
1985,ACES,Agricultural Sciences,61,36,25
1986,ACES,Agricultural Sciences,58,40,18
1987,ACES,Agricultural Sciences,51,35,16
1988,ACES,Agricultural Sciences,44,31,13
1989,ACES,Agricultural Sciences,31,22,9
1990,ACES,Agricultural Sciences,37,21,16
1991,ACES,Agricultural Sciences,43,25,18
1992,ACES,Agricultural Sciences,38,21,17
1993,ACES,Agricultural Sciences,38,18,20
1994,ACES,Agricultural Sciences,36,20,16
1995,ACES,Agricultural Sciences,40,23,17
1996,ACES,Agricultural Sciences,39,23,16
1997,ACES,Agricultural Sciences,15,11,4
1998,ACES,Agricultural Sciences,10,7,3
1999,ACES,Agricultural Sciences,2,1,1
2015,ACES,Agriculture,1,1,0
1980,ACES,Agronomy,89,67,22
1980,ACES,Agronomy,84,66,18
1981,ACES,Agronomy,113,84,29
1981,ACES,Agronomy,88,72,16
1982,ACES,Agronomy,93,64,29
1982,ACES,Agronomy,86,68,18
1983,ACES,Agronomy,79,65,14
1983,ACES,Agronomy,89,63,26
1984,ACES,Agronomy,92,77,15
1984,ACES,Agronomy,95,71,24
1985,ACES,Agronomy,93,74,19
1985,ACES,Agronomy,100,77,23
1986,ACES,Agronomy,83,67,16
1986,ACES,Agronomy,93,69,24
1987,ACES,Agronomy,66,53,13
1987,ACES,Agronomy,101,76,25
1988,ACES,Agronomy,52,45,7
1988,ACES,Agronomy,87,65,22
1989,ACES,Agronomy,40,36,4
1989,ACES,Agronomy,84,62,22
1990,ACES,Agronomy,41,34,7
1990,ACES,Agronomy,82,65,17
1991,ACES,Agronomy,41,29,12
1991,ACES,Agronomy,2,1,1
1991,ACES,Agronomy,90,71,19
1992,ACES,Agronomy,41,31,10
1992,ACES,Agronomy,81,63,18
1993,ACES,Agronomy,58,46,12
1993,ACES,Agronomy,74,52,22
1994,ACES,Agronomy,68,50,18
1994,ACES,Agronomy,80,54,26
1995,ACES,Agronomy,85,56,29
1995,ACES,Agronomy,77,51,26
1996,ACES,Agronomy,79,56,23
1996,ACES,Agronomy,73,52,21
1997,ACES,Agronomy,39,28,11
1997,ACES,Agronomy,69,48,21
1998,ACES,Agronomy,16,12,4
1998,ACES,Agronomy,39,28,11
1999,ACES,Agronomy,4,2,2
1999,ACES,Agronomy,20,13,7
2000,ACES,Agronomy,9,5,4
2001,ACES,Agronomy,3,1,2
1980,Aviation,Air Systems,172,152,20
1981,Aviation,Air Systems,143,134,9
1982,Aviation,Air Systems,135,126,9
1983,Aviation,Air Systems,115,102,13
1984,Aviation,Air Systems,90,79,11
1985,Aviation,Air Systems,62,55,7
1986,Aviation,Air Systems,25,23,2
1989,Aviation,Air Systems,18,16,2
1990,Aviation,Air Systems,16,13,3
1995,Aviation,Air Systems,3,2,1
2013,LAS,American Civilization,1,0,1
2006,LAS,American Civilization,1,1,0
1980,ACES,Animal Sciences,387,183,204
1980,ACES,Animal Sciences,98,60,38
1981,ACES,Animal Sciences,405,192,213
1981,ACES,Animal Sciences,3,2,1
1981,ACES,Animal Sciences,90,58,32
1982,ACES,Animal Sciences,416,203,213
1982,ACES,Animal Sciences,91,57,34
1983,ACES,Animal Sciences,381,156,225
1983,ACES,Animal Sciences,92,61,31
1984,ACES,Animal Sciences,365,149,216
1984,ACES,Animal Sciences,99,69,30
1985,ACES,Animal Sciences,335,142,193
1985,ACES,Animal Sciences,106,71,35
1986,ACES,Animal Sciences,284,119,165
1986,ACES,Animal Sciences,107,77,30
1987,ACES,Animal Sciences,266,120,146
1987,ACES,Animal Sciences,114,78,36
1988,ACES,Animal Sciences,260,101,159
1988,ACES,Animal Sciences,3,1,2
1988,ACES,Animal Sciences,117,78,39
1989,ACES,Animal Sciences,279,117,162
1989,ACES,Animal Sciences,2,1,1
1989,ACES,Animal Sciences,110,73,37
1990,ACES,Animal Sciences,299,130,169
1990,ACES,Animal Sciences,106,71,35
1991,ACES,Animal Sciences,299,119,180
1991,ACES,Animal Sciences,3,2,1
1991,ACES,Animal Sciences,108,70,38
1992,ACES,Animal Sciences,328,128,200
1992,ACES,Animal Sciences,103,64,39
1993,ACES,Animal Sciences,341,143,198
1993,ACES,Animal Sciences,98,62,36
1994,ACES,Animal Sciences,364,145,219
1994,ACES,Animal Sciences,112,73,39
1995,ACES,Animal Sciences,419,153,266
1995,ACES,Animal Sciences,105,72,33
1996,ACES,Animal Sciences,440,148,292
1996,ACES,Animal Sciences,101,74,27
1997,ACES,Animal Sciences,304,95,209
1997,ACES,Animal Sciences,94,70,24
1998,ACES,Animal Sciences,183,53,130
1998,ACES,Animal Sciences,96,64,32
1999,ACES,Animal Sciences,76,21,55
1999,ACES,Animal Sciences,98,63,35
2000,ACES,Animal Sciences,17,7,10
2000,ACES,Animal Sciences,99,57,42
2001,ACES,Animal Sciences,4,1,3
2001,ACES,Animal Sciences,104,53,51
2002,ACES,Animal Sciences,5,2,3
2002,ACES,Animal Sciences,106,55,51
2003,ACES,Animal Sciences,2,1,1
2003,ACES,Animal Sciences,103,49,54
1999,ACES,Animal Sciences,10,5,5
2000,ACES,Animal Sciences,16,6,10
2001,ACES,Animal Sciences,21,12,9
2002,ACES,Animal Sciences,28,14,14
2003,ACES,Animal Sciences,20,12,8
1999,ACES,Animal Sciences,22,3,19
2000,ACES,Animal Sciences,58,6,52
2001,ACES,Animal Sciences,89,8,81
2002,ACES,Animal Sciences,105,12,93
2003,ACES,Animal Sciences,95,10,85
1999,ACES,Animal Sciences,3,1,2
2000,ACES,Animal Sciences,9,4,5
2001,ACES,Animal Sciences,10,5,5
2002,ACES,Animal Sciences,18,8,10
2003,ACES,Animal Sciences,20,9,11
1997,ACES,Animal Sciences,15,7,8
1998,ACES,Animal Sciences,39,14,25
1999,ACES,Animal Sciences,21,9,12
2000,ACES,Animal Sciences,8,2,6
2001,ACES,Animal Sciences,6,1,5
1999,ACES,Animal Sciences,174,40,134
2000,ACES,Animal Sciences,253,63,190
2001,ACES,Animal Sciences,301,67,234
2002,ACES,Animal Sciences,329,75,254
2003,ACES,Animal Sciences,331,77,254
1997,ACES,Animal Sciences,136,33,103
1998,ACES,Animal Sciences,261,68,193
1999,ACES,Animal Sciences,190,51,139
2000,ACES,Animal Sciences,120,26,94
2001,ACES,Animal Sciences,57,15,42
2018,ACES,Animal Sciences,7,2,5
2018,ACES,Animal Sciences,64,6,57
2018,ACES,Animal Sciences,1,0,1
2018,ACES,Animal Sciences,432,76,355
2018,ACES,Animal Sciences,24,6,18
2018,ACES,Animal Sciences,4,2,2
2018,ACES,Animal Sciences,54,17,37
2018,ACES,Animal Sciences,40,19,21
2017,ACES,Animal Sciences,2,1,1
2017,ACES,Animal Sciences,67,5,62
2017,ACES,Animal Sciences,405,52,352
2017,ACES,Animal Sciences,21,8,13
2017,ACES,Animal Sciences,51,15,36
2017,ACES,Animal Sciences,39,18,21
2016,ACES,Animal Sciences,28,10,18
2016,ACES,Animal Sciences,70,9,61
2016,ACES,Animal Sciences,415,54,361
2016,ACES,Animal Sciences,52,17,35
2016,ACES,Animal Sciences,36,17,19
2015,ACES,Animal Sciences,1,0,1
2015,ACES,Animal Sciences,1,0,1
2015,ACES,Animal Sciences,42,12,30
2015,ACES,Animal Sciences,70,8,62
2015,ACES,Animal Sciences,56,18,38
2015,ACES,Animal Sciences,41,22,19
2015,ACES,Animal Sciences,409,63,346
2014,ACES,Animal Sciences,1,0,1
2014,ACES,Animal Sciences,5,1,4
2014,ACES,Animal Sciences,33,11,22
2014,ACES,Animal Sciences,74,8,66
2014,ACES,Animal Sciences,52,17,35
2014,ACES,Animal Sciences,421,69,352
2014,ACES,Animal Sciences,46,28,18
2013,ACES,Animal Sciences,1,0,1
2013,ACES,Animal Sciences,1,1,0
2013,ACES,Animal Sciences,1,0,1
2013,ACES,Animal Sciences,27,12,15
2013,ACES,Animal Sciences,46,30,16
2013,ACES,Animal Sciences,42,16,26
2013,ACES,Animal Sciences,72,9,63
2013,ACES,Animal Sciences,437,70,367
2012,ACES,Animal Sciences,7,1,6
2012,ACES,Animal Sciences,3,2,1
2012,ACES,Animal Sciences,17,2,15
2012,ACES,Animal Sciences,22,11,11
2012,ACES,Animal Sciences,38,20,18
2012,ACES,Animal Sciences,51,33,18
2012,ACES,Animal Sciences,88,13,75
2012,ACES,Animal Sciences,361,61,300
2011,ACES,Animal Sciences,3,1,2
2011,ACES,Animal Sciences,8,3,5
2011,ACES,Animal Sciences,10,4,6
2011,ACES,Animal Sciences,50,23,27
2011,ACES,Animal Sciences,45,28,17
2011,ACES,Animal Sciences,36,6,30
2011,ACES,Animal Sciences,101,12,89
2011,ACES,Animal Sciences,75,10,65
2011,ACES,Animal Sciences,232,43,188
2010,ACES,Animal Sciences,18,6,12
2010,ACES,Animal Sciences,7,2,5
2010,ACES,Animal Sciences,1,0,1
2010,ACES,Animal Sciences,1,0,1
2010,ACES,Animal Sciences,54,33,21
2010,ACES,Animal Sciences,14,5,9
2010,ACES,Animal Sciences,54,23,31
2010,ACES,Animal Sciences,130,26,103
2010,ACES,Animal Sciences,70,13,57
2010,ACES,Animal Sciences,44,6,38
2010,ACES,Animal Sciences,207,39,168
2009,ACES,Animal Sciences,17,8,9
2009,ACES,Animal Sciences,25,12,13
2009,ACES,Animal Sciences,103,17,86
2009,ACES,Animal Sciences,373,77,295
2009,ACES,Animal Sciences,48,24,24
2009,ACES,Animal Sciences,54,30,24
2008,ACES,Animal Sciences,19,12,7
2008,ACES,Animal Sciences,33,17,16
2008,ACES,Animal Sciences,94,12,82
2008,ACES,Animal Sciences,395,75,319
2008,ACES,Animal Sciences,48,30,18
2008,ACES,Animal Sciences,55,27,28
2007,ACES,Animal Sciences,19,15,4
2007,ACES,Animal Sciences,34,16,18
2007,ACES,Animal Sciences,108,16,92
2007,ACES,Animal Sciences,378,88,289
2007,ACES,Animal Sciences,51,26,25
2007,ACES,Animal Sciences,48,26,22
2006,ACES,Animal Sciences,1,1,0
2006,ACES,Animal Sciences,21,16,5
2006,ACES,Animal Sciences,117,19,98
2006,ACES,Animal Sciences,34,15,19
2006,ACES,Animal Sciences,354,92,261
2006,ACES,Animal Sciences,54,17,37
2006,ACES,Animal Sciences,36,22,14
2005,ACES,Animal Sciences,1,0,1
2005,ACES,Animal Sciences,23,14,9
2005,ACES,Animal Sciences,26,11,15
2005,ACES,Animal Sciences,115,17,98
2005,ACES,Animal Sciences,342,84,258
2005,ACES,Animal Sciences,54,17,37
2005,ACES,Animal Sciences,37,20,17
2004,ACES,Animal Sciences,1,0,1
2004,ACES,Animal Sciences,23,12,11
2004,ACES,Animal Sciences,104,16,88
2004,ACES,Animal Sciences,22,9,13
2004,ACES,Animal Sciences,351,83,268
2004,ACES,Animal Sciences,52,18,34
2004,ACES,Animal Sciences,1,0,1
2004,ACES,Animal Sciences,40,23,17
1980,LAS,Anthropology,78,42,36
1981,LAS,Anthropology,64,32,32
1982,LAS,Anthropology,70,34,36
1983,LAS,Anthropology,57,36,21
1984,LAS,Anthropology,59,32,27
1985,LAS,Anthropology,53,30,23
1986,LAS,Anthropology,71,36,35
1987,LAS,Anthropology,58,33,25
1988,LAS,Anthropology,68,39,29
1989,LAS,Anthropology,78,39,39
1990,LAS,Anthropology,78,36,42
1991,LAS,Anthropology,87,37,50
1992,LAS,Anthropology,97,41,56
1993,LAS,Anthropology,89,38,51
1994,LAS,Anthropology,99,43,56
1995,LAS,Anthropology,87,40,47
1996,LAS,Anthropology,75,27,48
1997,LAS,Anthropology,77,27,50
1998,LAS,Anthropology,71,22,49
1999,LAS,Anthropology,64,21,43
2000,LAS,Anthropology,64,24,40
2001,LAS,Anthropology,65,23,42
2002,LAS,Anthropology,63,24,39
2003,LAS,Anthropology,68,24,44
1984,ACES,Application Design,18,1,17
1985,ACES,Application Design,18,1,17
1986,LAS,Applied Mathematics,27,16,11
1987,LAS,Applied Mathematics,28,16,12
1988,LAS,Applied Mathematics,26,13,13
1989,LAS,Applied Mathematics,21,10,11
1990,LAS,Applied Mathematics,40,19,21
1991,LAS,Applied Mathematics,24,10,14
1992,LAS,Applied Mathematics,25,10,15
1993,LAS,Applied Mathematics,30,11,19
1994,LAS,Applied Mathematics,22,9,13
1995,LAS,Applied Mathematics,15,6,9
1996,LAS,Applied Mathematics,16,6,10
1997,LAS,Applied Mathematics,18,9,9
1998,LAS,Applied Mathematics,12,7,5
1999,LAS,Applied Mathematics,13,7,6
2000,LAS,Applied Mathematics,11,5,6
2001,LAS,Applied Mathematics,8,3,5
2002,LAS,Applied Mathematics,13,10,3
2003,LAS,Applied Mathematics,14,11,3
1980,Fine and Applied Arts,Architectural Studies,627,474,153
1981,Fine and Applied Arts,Architectural Studies,597,434,163
1982,Fine and Applied Arts,Architectural Studies,583,412,171
1983,Fine and Applied Arts,Architectural Studies,558,395,163
1984,Fine and Applied Arts,Architectural Studies,581,415,166
1985,Fine and Applied Arts,Architectural Studies,604,435,169
1986,Fine and Applied Arts,Architectural Studies,598,423,175
1987,Fine and Applied Arts,Architectural Studies,617,447,170
1988,Fine and Applied Arts,Architectural Studies,587,415,172
1989,Fine and Applied Arts,Architectural Studies,585,406,179
1990,Fine and Applied Arts,Architectural Studies,585,403,182
1991,Fine and Applied Arts,Architectural Studies,564,380,184
1992,Fine and Applied Arts,Architectural Studies,505,335,170
1993,Fine and Applied Arts,Architectural Studies,488,326,162
1994,Fine and Applied Arts,Architectural Studies,492,326,166
1995,Fine and Applied Arts,Architectural Studies,509,324,185
1996,Fine and Applied Arts,Architectural Studies,524,345,179
1997,Fine and Applied Arts,Architectural Studies,515,319,196
1998,Fine and Applied Arts,Architectural Studies,532,324,208
1999,Fine and Applied Arts,Architectural Studies,535,328,207
2000,Fine and Applied Arts,Architectural Studies,512,300,212
2001,Fine and Applied Arts,Architectural Studies,512,298,214
2002,Fine and Applied Arts,Architectural Studies,513,305,208
2003,Fine and Applied Arts,Architectural Studies,529,300,229
2018,Fine and Applied Arts,Architectural Studies,6,3,3
2018,Fine and Applied Arts,Architectural Studies,410,246,164
2018,Fine and Applied Arts,Architectural Studies,2,2,0
2017,Fine and Applied Arts,Architectural Studies,430,248,182
2017,Fine and Applied Arts,Architectural Studies,2,1,1
2017,Fine and Applied Arts,Architectural Studies,1,1,0
2016,Fine and Applied Arts,Architectural Studies,416,241,175
2016,Fine and Applied Arts,Architectural Studies,1,0,1
2015,Fine and Applied Arts,Architectural Studies,4,2,2
2015,Fine and Applied Arts,Architectural Studies,398,218,180
2014,Fine and Applied Arts,Architectural Studies,5,3,2
2014,Fine and Applied Arts,Architectural Studies,431,237,194
2013,Fine and Applied Arts,Architectural Studies,1,1,0
2013,Fine and Applied Arts,Architectural Studies,443,246,197
2012,Fine and Applied Arts,Architectural Studies,4,2,2
2012,Fine and Applied Arts,Architectural Studies,478,272,206
2011,Fine and Applied Arts,Architectural Studies,2,0,2
2011,Fine and Applied Arts,Architectural Studies,505,286,219
2010,Fine and Applied Arts,Architectural Studies,2,1,1
2010,Fine and Applied Arts,Architectural Studies,503,290,213
2009,Fine and Applied Arts,Architectural Studies,2,2,0
2009,Fine and Applied Arts,Architectural Studies,552,317,235
2008,Fine and Applied Arts,Architectural Studies,3,2,1
2008,Fine and Applied Arts,Architectural Studies,578,322,256
2007,Fine and Applied Arts,Architectural Studies,547,300,247
2006,Fine and Applied Arts,Architectural Studies,525,310,215
2005,Fine and Applied Arts,Architectural Studies,534,308,226
2004,Fine and Applied Arts,Architectural Studies,547,308,238
1980,Fine and Applied Arts,Architecture,27,22,5
1981,Fine and Applied Arts,Architecture,31,24,7
1982,Fine and Applied Arts,Architecture,20,15,5
1983,Fine and Applied Arts,Architecture,12,9,3
1984,Fine and Applied Arts,Architecture,10,9,1
1985,Fine and Applied Arts,Architecture,16,12,4
1986,Fine and Applied Arts,Architecture,25,17,8
1987,Fine and Applied Arts,Architecture,14,10,4
1988,Fine and Applied Arts,Architecture,18,12,6
1989,Fine and Applied Arts,Architecture,13,6,7
1990,Fine and Applied Arts,Architecture,7,5,2
1991,Fine and Applied Arts,Architecture,17,14,3
1992,Fine and Applied Arts,Architecture,6,4,2
1993,Fine and Applied Arts,Architecture,9,7,2
1995,Fine and Applied Arts,Architecture,6,4,2
1996,Fine and Applied Arts,Architecture,12,8,4
1997,Fine and Applied Arts,Architecture,9,6,3
1998,Fine and Applied Arts,Architecture,9,6,3
1999,Fine and Applied Arts,Architecture,4,3,1
2000,Fine and Applied Arts,Architecture,4,1,3
2001,Fine and Applied Arts,Architecture,5,2,3
2002,Fine and Applied Arts,Architecture,11,9,2
2003,Fine and Applied Arts,Architecture,10,4,6
1980,Fine and Applied Arts,Architecture,155,128,27
1981,Fine and Applied Arts,Architecture,177,148,29
1982,Fine and Applied Arts,Architecture,210,178,32
1983,Fine and Applied Arts,Architecture,202,168,34
1984,Fine and Applied Arts,Architecture,201,162,39
1985,Fine and Applied Arts,Architecture,197,160,37
1986,Fine and Applied Arts,Architecture,181,139,42
1987,Fine and Applied Arts,Architecture,206,158,48
1988,Fine and Applied Arts,Architecture,215,172,43
1989,Fine and Applied Arts,Architecture,185,148,37
1990,Fine and Applied Arts,Architecture,156,110,46
1991,Fine and Applied Arts,Architecture,174,126,48
1992,Fine and Applied Arts,Architecture,139,101,38
1993,Fine and Applied Arts,Architecture,129,96,33
1994,Fine and Applied Arts,Architecture,118,81,37
1995,Fine and Applied Arts,Architecture,129,86,43
1996,Fine and Applied Arts,Architecture,138,84,54
1997,Fine and Applied Arts,Architecture,123,80,43
1998,Fine and Applied Arts,Architecture,103,71,32
1999,Fine and Applied Arts,Architecture,104,67,37
2000,Fine and Applied Arts,Architecture,108,72,36
2001,Fine and Applied Arts,Architecture,117,75,42
2002,Fine and Applied Arts,Architecture,161,104,57
2003,Fine and Applied Arts,Architecture,169,116,53
1989,Fine and Applied Arts,Architecture,15,9,6
1990,Fine and Applied Arts,Architecture,36,22,14
1991,Fine and Applied Arts,Architecture,50,31,19
1992,Fine and Applied Arts,Architecture,60,39,21
1993,Fine and Applied Arts,Architecture,56,35,21
1994,Fine and Applied Arts,Architecture,54,35,19
1995,Fine and Applied Arts,Architecture,52,35,17
1996,Fine and Applied Arts,Architecture,57,35,22
1997,Fine and Applied Arts,Architecture,55,32,23
1998,Fine and Applied Arts,Architecture,41,23,18
1999,Fine and Applied Arts,Architecture,35,21,14
2000,Fine and Applied Arts,Architecture,37,21,16
2001,Fine and Applied Arts,Architecture,41,25,16
2002,Fine and Applied Arts,Architecture,38,21,17
2003,Fine and Applied Arts,Architecture,44,25,19
2001,Fine and Applied Arts,Architecture,2,1,1
2002,Fine and Applied Arts,Architecture,2,1,1
2003,Fine and Applied Arts,Architecture,4,2,2
1981,Fine and Applied Arts,Architecture,5,4,1
1982,Fine and Applied Arts,Architecture,5,4,1
2018,Fine and Applied Arts,Architecture,162,78,83
2018,Fine and Applied Arts,Architecture,23,10,13
2018,Fine and Applied Arts,Architecture,14,11,3
2017,Fine and Applied Arts,Architecture,144,67,77
2017,Fine and Applied Arts,Architecture,23,10,13
2017,Fine and Applied Arts,Architecture,12,9,3
2016,Fine and Applied Arts,Architecture,122,60,62
2016,Fine and Applied Arts,Architecture,25,14,11
2016,Fine and Applied Arts,Architecture,12,9,3
2015,Fine and Applied Arts,Architecture,12,10,2
2015,Fine and Applied Arts,Architecture,34,21,13
2015,Fine and Applied Arts,Architecture,126,74,52
2014,Fine and Applied Arts,Architecture,13,8,5
2014,Fine and Applied Arts,Architecture,30,18,12
2014,Fine and Applied Arts,Architecture,115,71,44
2013,Fine and Applied Arts,Architecture,12,5,7
2013,Fine and Applied Arts,Architecture,130,84,46
2013,Fine and Applied Arts,Architecture,36,24,12
2012,Fine and Applied Arts,Architecture,13,6,7
2012,Fine and Applied Arts,Architecture,146,89,57
2012,Fine and Applied Arts,Architecture,37,21,16
2011,Fine and Applied Arts,Architecture,14,6,8
2011,Fine and Applied Arts,Architecture,34,19,15
2011,Fine and Applied Arts,Architecture,171,106,65
2010,Fine and Applied Arts,Architecture,2,0,2
2010,Fine and Applied Arts,Architecture,15,7,8
2010,Fine and Applied Arts,Architecture,30,14,16
2010,Fine and Applied Arts,Architecture,143,81,62
2009,Fine and Applied Arts,Architecture,19,11,8
2009,Fine and Applied Arts,Architecture,3,2,1
2009,Fine and Applied Arts,Architecture,14,7,7
2009,Fine and Applied Arts,Architecture,158,95,63
2008,Fine and Applied Arts,Architecture,5,4,1
2008,Fine and Applied Arts,Architecture,27,16,11
2008,Fine and Applied Arts,Architecture,15,7,8
2008,Fine and Applied Arts,Architecture,151,97,54
2007,Fine and Applied Arts,Architecture,3,1,2
2007,Fine and Applied Arts,Architecture,3,0,3
2007,Fine and Applied Arts,Architecture,39,22,17
2007,Fine and Applied Arts,Architecture,14,6,8
2007,Fine and Applied Arts,Architecture,149,95,54
2006,Fine and Applied Arts,Architecture,5,5,0
2006,Fine and Applied Arts,Architecture,5,5,0
2006,Fine and Applied Arts,Architecture,12,6,6
2006,Fine and Applied Arts,Architecture,49,30,19
2006,Fine and Applied Arts,Architecture,161,94,67
2005,Fine and Applied Arts,Architecture,2,2,0
2005,Fine and Applied Arts,Architecture,4,2,2
2005,Fine and Applied Arts,Architecture,9,4,5
2005,Fine and Applied Arts,Architecture,40,20,19
2005,Fine and Applied Arts,Architecture,148,86,62
2004,Fine and Applied Arts,Architecture,3,1,2
2004,Fine and Applied Arts,Architecture,147,99,48
2004,Fine and Applied Arts,Architecture,45,22,23
2004,Fine and Applied Arts,Architecture,4,1,3
2004,Fine and Applied Arts,Architecture,3,2,1
2001,Fine and Applied Arts,Art and Design,6,5,1
2002,Fine and Applied Arts,Art and Design,7,4,3
2003,Fine and Applied Arts,Art and Design,5,3,2
1998,Fine and Applied Arts,Art and Design,4,2,2
1999,Fine and Applied Arts,Art and Design,5,3,2
2000,Fine and Applied Arts,Art and Design,6,3,3
2001,Fine and Applied Arts,Art and Design,4,2,2
2002,Fine and Applied Arts,Art and Design,5,2,3
2003,Fine and Applied Arts,Art and Design,4,2,2
1998,Fine and Applied Arts,Art and Design,3,2,1
1999,Fine and Applied Arts,Art and Design,10,6,4
2000,Fine and Applied Arts,Art and Design,9,5,4
2001,Fine and Applied Arts,Art and Design,10,3,7
2002,Fine and Applied Arts,Art and Design,9,2,7
2003,Fine and Applied Arts,Art and Design,11,4,7
1998,Fine and Applied Arts,Art and Design,4,2,2
1999,Fine and Applied Arts,Art and Design,4,3,1
2000,Fine and Applied Arts,Art and Design,3,2,1
2001,Fine and Applied Arts,Art and Design,6,4,2
2002,Fine and Applied Arts,Art and Design,7,3,4
2003,Fine and Applied Arts,Art and Design,7,3,4
1999,Fine and Applied Arts,Art and Design,3,1,2
2000,Fine and Applied Arts,Art and Design,3,1,2
1998,Fine and Applied Arts,Art and Design,5,4,1
1999,Fine and Applied Arts,Art and Design,11,6,5
2000,Fine and Applied Arts,Art and Design,10,7,3
2001,Fine and Applied Arts,Art and Design,12,5,7
2002,Fine and Applied Arts,Art and Design,10,5,5
2003,Fine and Applied Arts,Art and Design,10,5,5
1980,Fine and Applied Arts,Art and Design,65,38,27
1981,Fine and Applied Arts,Art and Design,61,35,26
1982,Fine and Applied Arts,Art and Design,61,34,27
1983,Fine and Applied Arts,Art and Design,59,32,27
1984,Fine and Applied Arts,Art and Design,63,34,29
1985,Fine and Applied Arts,Art and Design,64,43,21
1986,Fine and Applied Arts,Art and Design,67,45,22
1987,Fine and Applied Arts,Art and Design,62,41,21
1988,Fine and Applied Arts,Art and Design,61,38,23
1989,Fine and Applied Arts,Art and Design,66,38,28
1990,Fine and Applied Arts,Art and Design,68,37,31
1991,Fine and Applied Arts,Art and Design,66,37,29
1992,Fine and Applied Arts,Art and Design,68,41,27
1993,Fine and Applied Arts,Art and Design,62,38,24
1994,Fine and Applied Arts,Art and Design,62,32,30
1995,Fine and Applied Arts,Art and Design,52,26,26
1996,Fine and Applied Arts,Art and Design,52,27,25
1997,Fine and Applied Arts,Art and Design,49,25,24
1998,Fine and Applied Arts,Art and Design,29,14,15
1999,Fine and Applied Arts,Art and Design,5,1,4
2000,Fine and Applied Arts,Art and Design,5,3,2
2001,Fine and Applied Arts,Art and Design,7,3,4
2002,Fine and Applied Arts,Art and Design,7,3,4
2003,Fine and Applied Arts,Art and Design,6,2,4
1980,Fine and Applied Arts,Art and Design,92,21,71
1981,Fine and Applied Arts,Art and Design,98,29,69
1982,Fine and Applied Arts,Art and Design,92,38,54
1983,Fine and Applied Arts,Art and Design,97,51,46
1984,Fine and Applied Arts,Art and Design,110,47,63
1985,Fine and Applied Arts,Art and Design,108,41,67
1986,Fine and Applied Arts,Art and Design,101,41,60
1987,Fine and Applied Arts,Art and Design,99,44,55
1988,Fine and Applied Arts,Art and Design,93,48,45
1989,Fine and Applied Arts,Art and Design,70,36,34
1990,Fine and Applied Arts,Art and Design,59,26,33
1991,Fine and Applied Arts,Art and Design,73,28,45
1992,Fine and Applied Arts,Art and Design,92,38,54
1993,Fine and Applied Arts,Art and Design,98,50,48
1994,Fine and Applied Arts,Art and Design,82,40,42
1995,Fine and Applied Arts,Art and Design,82,40,42
1996,Fine and Applied Arts,Art and Design,87,43,44
1997,Fine and Applied Arts,Art and Design,74,45,29
1998,Fine and Applied Arts,Art and Design,71,41,30
1999,Fine and Applied Arts,Art and Design,68,36,32
2000,Fine and Applied Arts,Art and Design,73,36,37
2001,Fine and Applied Arts,Art and Design,55,18,37
2002,Fine and Applied Arts,Art and Design,53,20,33
2003,Fine and Applied Arts,Art and Design,48,17,31
1987,Fine and Applied Arts,Art and Design,5,3,2
1988,Fine and Applied Arts,Art and Design,11,5,6
1989,Fine and Applied Arts,Art and Design,11,4,7
1990,Fine and Applied Arts,Art and Design,12,6,6
1991,Fine and Applied Arts,Art and Design,13,8,5
1992,Fine and Applied Arts,Art and Design,20,9,11
1993,Fine and Applied Arts,Art and Design,21,10,11
1994,Fine and Applied Arts,Art and Design,21,11,10
1995,Fine and Applied Arts,Art and Design,22,8,14
1996,Fine and Applied Arts,Art and Design,24,8,16
1997,Fine and Applied Arts,Art and Design,26,8,18
1998,Fine and Applied Arts,Art and Design,32,14,18
1999,Fine and Applied Arts,Art and Design,32,17,15
2000,Fine and Applied Arts,Art and Design,37,14,23
2001,Fine and Applied Arts,Art and Design,29,7,22
2002,Fine and Applied Arts,Art and Design,23,5,18
2003,Fine and Applied Arts,Art and Design,24,6,18
1980,Fine and Applied Arts,Art and Design,20,8,12
1981,Fine and Applied Arts,Art and Design,15,6,9
1982,Fine and Applied Arts,Art and Design,14,8,6
1983,Fine and Applied Arts,Art and Design,14,8,6
1984,Fine and Applied Arts,Art and Design,15,12,3
1985,Fine and Applied Arts,Art and Design,15,9,6
1986,Fine and Applied Arts,Art and Design,7,3,4
1987,Fine and Applied Arts,Art and Design,12,5,7
1988,Fine and Applied Arts,Art and Design,11,8,3
1989,Fine and Applied Arts,Art and Design,9,7,2
1990,Fine and Applied Arts,Art and Design,10,7,3
1991,Fine and Applied Arts,Art and Design,11,5,6
1992,Fine and Applied Arts,Art and Design,8,3,5
1993,Fine and Applied Arts,Art and Design,11,4,7
1994,Fine and Applied Arts,Art and Design,15,7,8
1995,Fine and Applied Arts,Art and Design,15,10,5
1996,Fine and Applied Arts,Art and Design,15,11,4
1997,Fine and Applied Arts,Art and Design,13,10,3
1998,Fine and Applied Arts,Art and Design,11,9,2
1999,Fine and Applied Arts,Art and Design,13,9,4
2000,Fine and Applied Arts,Art and Design,10,7,3
2001,Fine and Applied Arts,Art and Design,10,4,6
2002,Fine and Applied Arts,Art and Design,15,7,8
2003,Fine and Applied Arts,Art and Design,14,6,8
1980,Fine and Applied Arts,Art and Design,174,45,129
1981,Fine and Applied Arts,Art and Design,228,84,144
1982,Fine and Applied Arts,Art and Design,188,69,119
1983,Fine and Applied Arts,Art and Design,190,81,109
1984,Fine and Applied Arts,Art and Design,213,93,120
1985,Fine and Applied Arts,Art and Design,202,79,123
1986,Fine and Applied Arts,Art and Design,176,69,107
1987,Fine and Applied Arts,Art and Design,194,93,101
1988,Fine and Applied Arts,Art and Design,178,72,106
1989,Fine and Applied Arts,Art and Design,185,82,103
1990,Fine and Applied Arts,Art and Design,176,82,94
1991,Fine and Applied Arts,Art and Design,194,83,111
1992,Fine and Applied Arts,Art and Design,177,87,90
1993,Fine and Applied Arts,Art and Design,204,88,116
1994,Fine and Applied Arts,Art and Design,209,91,118
1995,Fine and Applied Arts,Art and Design,169,76,93
1996,Fine and Applied Arts,Art and Design,180,90,90
1997,Fine and Applied Arts,Art and Design,171,79,92
1998,Fine and Applied Arts,Art and Design,172,65,107
1999,Fine and Applied Arts,Art and Design,158,60,98
2000,Fine and Applied Arts,Art and Design,120,38,82
2001,Fine and Applied Arts,Art and Design,132,42,90
2002,Fine and Applied Arts,Art and Design,160,51,109
2003,Fine and Applied Arts,Art and Design,167,50,117
1980,Fine and Applied Arts,Art and Design,12,3,9
1981,Fine and Applied Arts,Art and Design,13,2,11
1982,Fine and Applied Arts,Art and Design,5,1,4
1985,Fine and Applied Arts,Art and Design,13,7,6
1986,Fine and Applied Arts,Art and Design,9,3,6
1987,Fine and Applied Arts,Art and Design,11,2,9
1988,Fine and Applied Arts,Art and Design,11,2,9
1989,Fine and Applied Arts,Art and Design,7,3,4
1990,Fine and Applied Arts,Art and Design,7,3,4
1991,Fine and Applied Arts,Art and Design,6,3,3
1992,Fine and Applied Arts,Art and Design,4,2,2
1993,Fine and Applied Arts,Art and Design,5,3,2
1994,Fine and Applied Arts,Art and Design,4,1,3
2018,Fine and Applied Arts,Art and Design,4,1,3
2018,Fine and Applied Arts,Art and Design,10,3,7
2018,Fine and Applied Arts,Art and Design,14,6,8
2018,Fine and Applied Arts,Art and Design,4,0,4
2018,Fine and Applied Arts,Art and Design,8,5,3
2018,Fine and Applied Arts,Art and Design,7,3,4
1980,LAS,Chemical Engineering,75,62,13
1980,LAS,Chemical Engineering,455,357,98
1981,LAS,Chemical Engineering,94,77,17
1981,LAS,Chemical Engineering,473,367,106
1982,LAS,Chemical Engineering,93,77,16
1982,LAS,Chemical Engineering,458,342,116
1983,LAS,Chemical Engineering,105,89,16
1983,LAS,Chemical Engineering,433,332,101
1984,LAS,Chemical Engineering,99,82,17
1984,LAS,Chemical Engineering,380,283,97
1985,LAS,Chemical Engineering,94,81,13
1985,LAS,Chemical Engineering,325,247,78
1986,LAS,Chemical Engineering,90,77,13
1986,LAS,Chemical Engineering,350,252,98
1987,LAS,Chemical Engineering,81,65,16
1987,LAS,Chemical Engineering,353,245,108
1988,LAS,Chemical Engineering,70,55,15
1988,LAS,Chemical Engineering,356,251,105
1989,LAS,Chemical Engineering,56,44,12
1989,LAS,Chemical Engineering,314,222,92
1990,LAS,Chemical Engineering,58,38,20
1990,LAS,Chemical Engineering,337,232,105
1991,LAS,Chemical Engineering,65,44,21
1991,LAS,Chemical Engineering,349,237,112
1992,LAS,Chemical Engineering,73,47,26
1992,LAS,Chemical Engineering,371,240,131
1993,LAS,Chemical Engineering,78,54,24
1993,LAS,Chemical Engineering,359,237,122
1994,LAS,Chemical Engineering,80,59,21
1994,LAS,Chemical Engineering,377,245,132
1995,LAS,Chemical Engineering,71,56,15
1995,LAS,Chemical Engineering,404,274,130
1996,LAS,Chemical Engineering,68,53,15
1996,LAS,Chemical Engineering,396,262,134
1997,LAS,Chemical Engineering,71,54,17
1997,LAS,Chemical Engineering,380,233,147
1998,LAS,Chemical Engineering,397,253,144
1998,LAS,Chemical Engineering,70,57,13
1999,LAS,Chemical Engineering,74,62,12
1999,LAS,Chemical Engineering,394,252,142
2000,LAS,Chemical Engineering,83,67,16
2000,LAS,Chemical Engineering,388,260,128
2001,LAS,Chemical Engineering,85,63,22
2001,LAS,Chemical Engineering,347,234,113
2002,LAS,Chemical Engineering,94,75,19
2002,LAS,Chemical Engineering,303,207,96
2003,LAS,Chemical Engineering,111,89,22
2003,LAS,Chemical Engineering,302,205,97
2017,Fine and Applied Arts,Art and Design,5,1,4
2017,Fine and Applied Arts,Art and Design,7,2,5
2017,Fine and Applied Arts,Art and Design,15,6,9
2017,Fine and Applied Arts,Art and Design,5,0,5
2017,Fine and Applied Arts,Art and Design,5,2,3
2017,Fine and Applied Arts,Art and Design,4,1,3
2016,Fine and Applied Arts,Art and Design,5,2,3
2016,Fine and Applied Arts,Art and Design,9,3,6
2016,Fine and Applied Arts,Art and Design,13,7,6
2016,Fine and Applied Arts,Art and Design,5,1,4
2016,Fine and Applied Arts,Art and Design,6,1,5
2016,Fine and Applied Arts,Art and Design,4,1,3
2016,Fine and Applied Arts,Art and Design,1,0,1
2015,Fine and Applied Arts,Art and Design,1,1,0
2015,Fine and Applied Arts,Art and Design,4,2,2
2015,Fine and Applied Arts,Art and Design,6,1,5
2015,Fine and Applied Arts,Art and Design,6,1,5
2015,Fine and Applied Arts,Art and Design,7,2,5
2015,Fine and Applied Arts,Art and Design,10,3,7
2015,Fine and Applied Arts,Art and Design,8,3,5
2014,Fine and Applied Arts,Art and Design,3,1,2
2014,Fine and Applied Arts,Art and Design,2,1,1
2014,Fine and Applied Arts,Art and Design,3,2,1
2014,Fine and Applied Arts,Art and Design,6,1,5
1980,LAS,Chemistry,292,229,63
1980,LAS,Chemistry,239,179,60
1981,LAS,Chemistry,289,229,60
1981,LAS,Chemistry,248,180,68
1982,LAS,Chemistry,284,222,62
1982,LAS,Chemistry,266,193,73
1983,LAS,Chemistry,280,215,65
1983,LAS,Chemistry,277,183,94
1984,LAS,Chemistry,279,218,61
1984,LAS,Chemistry,258,176,82
1985,LAS,Chemistry,274,211,63
1985,LAS,Chemistry,257,173,84
1986,LAS,Chemistry,300,227,73
1986,LAS,Chemistry,222,139,83
1987,LAS,Chemistry,301,229,72
1987,LAS,Chemistry,223,144,79
1988,LAS,Chemistry,272,202,70
1988,LAS,Chemistry,206,127,79
1989,LAS,Chemistry,269,195,74
1989,LAS,Chemistry,193,122,71
1990,LAS,Chemistry,276,209,67
1990,LAS,Chemistry,211,133,78
1991,LAS,Chemistry,248,192,56
1991,LAS,Chemistry,205,144,61
1992,LAS,Chemistry,271,202,69
1992,LAS,Chemistry,190,134,56
1993,LAS,Chemistry,264,201,63
1993,LAS,Chemistry,227,152,75
1994,LAS,Chemistry,264,199,65
1994,LAS,Chemistry,204,137,67
1995,LAS,Chemistry,297,211,86
1995,LAS,Chemistry,194,123,71
1996,LAS,Chemistry,263,189,74
1996,LAS,Chemistry,176,103,73
1997,LAS,Chemistry,265,178,87
1997,LAS,Chemistry,150,84,66
1998,LAS,Chemistry,135,89,46
1998,LAS,Chemistry,261,173,88
1999,LAS,Chemistry,266,172,94
1999,LAS,Chemistry,134,84,50
2000,LAS,Chemistry,266,161,105
2000,LAS,Chemistry,104,67,37
2001,LAS,Chemistry,276,171,105
2001,LAS,Chemistry,120,74,46
2002,LAS,Chemistry,265,173,92
2002,LAS,Chemistry,105,64,41
2003,LAS,Chemistry,290,183,107
2003,LAS,Chemistry,101,61,40
2014,Fine and Applied Arts,Art and Design,6,1,5
2014,Fine and Applied Arts,Art and Design,8,1,7
2014,Fine and Applied Arts,Art and Design,9,4,5
2013,Fine and Applied Arts,Art and Design,2,0,2
2013,Fine and Applied Arts,Art and Design,4,2,2
2013,Fine and Applied Arts,Art and Design,10,3,7
2013,Fine and Applied Arts,Art and Design,7,0,7
2013,Fine and Applied Arts,Art and Design,7,3,4
2013,Fine and Applied Arts,Art and Design,4,2,2
2013,Fine and Applied Arts,Art and Design,6,0,6
2012,Fine and Applied Arts,Art and Design,5,3,2
2012,Fine and Applied Arts,Art and Design,5,2,3
2012,Fine and Applied Arts,Art and Design,7,3,4
2012,Fine and Applied Arts,Art and Design,5,0,5
2012,Fine and Applied Arts,Art and Design,9,4,5
2012,Fine and Applied Arts,Art and Design,3,1,2
2012,Fine and Applied Arts,Art and Design,4,0,4
2012,Fine and Applied Arts,Art and Design,1,0,1
2011,Fine and Applied Arts,Art and Design,5,4,1
2011,Fine and Applied Arts,Art and Design,2,1,1
2011,Fine and Applied Arts,Art and Design,9,6,3
2011,Fine and Applied Arts,Art and Design,6,2,4
2011,Fine and Applied Arts,Art and Design,9,4,5
2011,Fine and Applied Arts,Art and Design,3,2,1
1980,Engineering,Civil Engineering,648,561,87
1980,Engineering,Civil Engineering,7,3,4
1980,Engineering,Civil Engineering,22,16,6
1980,Engineering,Civil Engineering,225,212,13
1981,Engineering,Civil Engineering,572,488,84
1981,Engineering,Civil Engineering,6,3,3
1981,Engineering,Civil Engineering,15,10,5
1981,Engineering,Civil Engineering,218,200,18
1982,Engineering,Civil Engineering,456,380,76
1982,Engineering,Civil Engineering,3,1,2
1982,Engineering,Civil Engineering,17,9,8
1982,Engineering,Civil Engineering,196,178,18
1983,Engineering,Civil Engineering,351,295,56
1983,Engineering,Civil Engineering,11,6,5
1983,Engineering,Civil Engineering,13,7,6
1983,Engineering,Civil Engineering,236,209,27
1984,Engineering,Civil Engineering,313,260,53
1984,Engineering,Civil Engineering,11,6,5
1984,Engineering,Civil Engineering,7,4,3
1984,Engineering,Civil Engineering,221,199,22
1985,Engineering,Civil Engineering,302,248,54
1985,Engineering,Civil Engineering,17,11,6
1985,Engineering,Civil Engineering,6,4,2
1985,Engineering,Civil Engineering,204,189,15
1986,Engineering,Civil Engineering,317,261,56
1986,Engineering,Civil Engineering,15,10,5
1986,Engineering,Civil Engineering,8,6,2
1986,Engineering,Civil Engineering,213,193,20
1987,Engineering,Civil Engineering,340,275,65
1987,Engineering,Civil Engineering,11,6,5
1987,Engineering,Civil Engineering,11,6,5
1987,Engineering,Civil Engineering,205,187,18
1988,Engineering,Civil Engineering,411,340,71
1988,Engineering,Civil Engineering,11,8,3
1988,Engineering,Civil Engineering,19,10,9
1988,Engineering,Civil Engineering,200,186,14
1989,Engineering,Civil Engineering,448,378,70
1989,Engineering,Civil Engineering,24,16,8
1989,Engineering,Civil Engineering,205,187,18
1990,Engineering,Civil Engineering,480,407,73
1990,Engineering,Civil Engineering,24,18,6
1990,Engineering,Civil Engineering,243,220,23
1991,Engineering,Civil Engineering,576,475,101
1991,Engineering,Civil Engineering,27,18,9
1991,Engineering,Civil Engineering,214,189,25
1992,Engineering,Civil Engineering,649,533,116
1992,Engineering,Civil Engineering,5,3,2
1992,Engineering,Civil Engineering,36,27,9
1992,Engineering,Civil Engineering,244,219,25
1993,Engineering,Civil Engineering,800,652,148
1993,Engineering,Civil Engineering,55,45,10
1993,Engineering,Civil Engineering,264,230,34
1994,Engineering,Civil Engineering,784,624,160
1994,Engineering,Civil Engineering,7,5,2
1994,Engineering,Civil Engineering,57,54,3
1994,Engineering,Civil Engineering,292,256,36
1995,Engineering,Civil Engineering,707,542,165
1995,Engineering,Civil Engineering,5,4,1
1995,Engineering,Civil Engineering,50,48,2
1995,Engineering,Civil Engineering,306,267,39
1996,Engineering,Civil Engineering,652,495,157
1996,Engineering,Civil Engineering,3,2,1
1996,Engineering,Civil Engineering,30,27,3
1996,Engineering,Civil Engineering,288,248,40
1997,Engineering,Civil Engineering,613,453,160
1997,Engineering,Civil Engineering,8,7,1
1997,Engineering,Civil Engineering,22,18,4
1997,Engineering,Civil Engineering,275,232,43
1998,Engineering,Civil Engineering,557,421,136
1998,Engineering,Civil Engineering,7,4,3
1998,Engineering,Civil Engineering,18,14,4
1998,Engineering,Civil Engineering,263,219,44
1999,Engineering,Civil Engineering,517,392,125
1999,Engineering,Civil Engineering,15,8,7
1999,Engineering,Civil Engineering,256,216,40
2000,Engineering,Civil Engineering,511,406,105
2000,Engineering,Civil Engineering,9,4,5
2000,Engineering,Civil Engineering,260,213,47
2001,Engineering,Civil Engineering,491,375,116
2001,Engineering,Civil Engineering,2,1,1
2001,Engineering,Civil Engineering,3,1,2
2001,Engineering,Civil Engineering,280,230,50
2002,Engineering,Civil Engineering,464,356,108
2002,Engineering,Civil Engineering,4,3,1
2002,Engineering,Civil Engineering,323,265,58
2003,Engineering,Civil Engineering,466,357,109
2003,Engineering,Civil Engineering,325,266,59
2011,Fine and Applied Arts,Art and Design,5,1,4
2010,Fine and Applied Arts,Art and Design,4,4,0
2010,Fine and Applied Arts,Art and Design,2,2,0
2010,Fine and Applied Arts,Art and Design,11,6,5
2010,Fine and Applied Arts,Art and Design,7,3,4
2010,Fine and Applied Arts,Art and Design,8,3,5
2010,Fine and Applied Arts,Art and Design,3,1,2
2010,Fine and Applied Arts,Art and Design,3,1,2
2009,Fine and Applied Arts,Art and Design,1,0,1
2009,Fine and Applied Arts,Art and Design,3,1,2
2009,Fine and Applied Arts,Art and Design,3,1,2
2009,Fine and Applied Arts,Art and Design,6,3,3
2009,Fine and Applied Arts,Art and Design,7,3,4
2009,Fine and Applied Arts,Art and Design,6,2,4
2009,Fine and Applied Arts,Art and Design,8,2,6
2009,Fine and Applied Arts,Art and Design,11,6,5
2008,Fine and Applied Arts,Art and Design,2,0,2
2008,Fine and Applied Arts,Art and Design,3,3,0
2008,Fine and Applied Arts,Art and Design,4,2,2
2008,Fine and Applied Arts,Art and Design,6,3,3
2008,Fine and Applied Arts,Art and Design,5,2,3
2008,Fine and Applied Arts,Art and Design,8,4,4
2008,Fine and Applied Arts,Art and Design,6,0,6
2008,Fine and Applied Arts,Art and Design,8,3,5
1980,LAS,Classics,8,7,1
1982,LAS,Classics,5,4,1
1983,LAS,Classics,6,5,1
1984,LAS,Classics,3,2,1
1985,LAS,Classics,9,7,2
1986,LAS,Classics,9,7,2
1987,LAS,Classics,6,3,3
1988,LAS,Classics,5,2,3
1989,LAS,Classics,7,4,3
1990,LAS,Classics,15,7,8
1991,LAS,Classics,16,9,7
1992,LAS,Classics,13,8,5
1993,LAS,Classics,7,6,1
1994,LAS,Classics,11,8,3
1995,LAS,Classics,9,6,3
1996,LAS,Classics,10,6,4
1997,LAS,Classics,8,5,3
1998,LAS,Classics,7,4,3
1999,LAS,Classics,8,7,1
2000,LAS,Classics,7,4,3
2001,LAS,Classics,5,3,2
2002,LAS,Classics,4,1,3
2003,LAS,Classics,3,1,2
2007,Fine and Applied Arts,Art and Design,2,1,1
2007,Fine and Applied Arts,Art and Design,1,0,1
2007,Fine and Applied Arts,Art and Design,6,4,2
2007,Fine and Applied Arts,Art and Design,5,3,2
2007,Fine and Applied Arts,Art and Design,6,2,4
2007,Fine and Applied Arts,Art and Design,8,5,3
2007,Fine and Applied Arts,Art and Design,6,1,5
2007,Fine and Applied Arts,Art and Design,9,5,4
1980,Applied Life Sciences,Community Health,41,18,23
1981,Applied Life Sciences,Community Health,39,15,24
1982,Applied Life Sciences,Community Health,37,10,27
1983,Applied Life Sciences,Community Health,30,11,19
1983,Applied Life Sciences,Community Health,32,11,21
1984,Applied Life Sciences,Community Health,31,9,22
1984,Applied Life Sciences,Community Health,63,23,40
1985,Applied Life Sciences,Community Health,24,10,14
1985,Applied Life Sciences,Community Health,76,25,51
1986,Applied Life Sciences,Community Health,25,8,17
1986,Applied Life Sciences,Community Health,107,30,77
1987,Applied Life Sciences,Community Health,26,6,20
1987,Applied Life Sciences,Community Health,128,44,84
1988,Applied Life Sciences,Community Health,23,4,19
1988,Applied Life Sciences,Community Health,83,30,53
1989,Applied Life Sciences,Community Health,23,5,18
1989,Applied Life Sciences,Community Health,65,21,44
1990,Applied Life Sciences,Community Health,28,9,19
1990,Applied Life Sciences,Community Health,84,28,56
1991,Applied Life Sciences,Community Health,29,8,21
1991,Applied Life Sciences,Community Health,91,32,59
1992,Applied Life Sciences,Community Health,18,6,12
1992,Applied Life Sciences,Community Health,110,26,84
1993,Applied Life Sciences,Community Health,22,8,14
1993,Applied Life Sciences,Community Health,101,25,76
1994,Applied Life Sciences,Community Health,24,9,15
1994,Applied Life Sciences,Community Health,78,20,58
1995,Applied Life Sciences,Community Health,24,10,14
1995,Applied Life Sciences,Community Health,107,25,82
1996,Applied Life Sciences,Community Health,26,8,18
1996,Applied Life Sciences,Community Health,106,24,82
1997,Applied Life Sciences,Community Health,26,10,16
1997,Applied Life Sciences,Community Health,66,12,54
1998,Applied Life Sciences,Community Health,54,13,41
1998,Applied Life Sciences,Community Health,24,7,17
1999,Applied Life Sciences,Community Health,19,6,13
1999,Applied Life Sciences,Community Health,54,13,41
2000,Applied Life Sciences,Community Health,17,7,10
2000,Applied Life Sciences,Community Health,73,11,62
2001,Applied Life Sciences,Community Health,21,6,15
2001,Applied Life Sciences,Community Health,72,20,52
2002,Applied Life Sciences,Community Health,20,6,14
2002,Applied Life Sciences,Community Health,65,20,45
2003,Applied Life Sciences,Community Health,29,10,19
2003,Applied Life Sciences,Community Health,72,16,56
1980,Media,Communication,27,12,15
1981,Media,Communication,38,15,23
1982,Media,Communication,41,18,23
1983,Media,Communication,36,14,22
1984,Media,Communication,37,18,19
1985,Media,Communication,33,18,15
1986,Media,Communication,43,21,22
1987,Media,Communication,40,20,20
1988,Media,Communication,33,22,11
1989,Media,Communication,37,23,14
1990,Media,Communication,40,25,15
1991,Media,Communication,36,22,14
1992,Media,Communication,32,20,12
1993,Media,Communication,37,20,17
1994,Media,Communication,39,19,20
1995,Media,Communication,41,19,22
1996,Media,Communication,37,13,24
1997,Media,Communication,36,14,22
1998,Media,Communication,33,14,19
1999,Media,Communication,34,14,20
2000,Media,Communication,35,11,24
2001,Media,Communication,36,11,25
2002,Media,Communication,49,22,27
2003,Media,Communication,54,23,31
1980,Engineering,Computer Engineering,273,241,32
1980,Engineering,Computer Engineering,13,11,2
1981,Engineering,Computer Engineering,307,265,42
1981,Engineering,Computer Engineering,4,3,1
1981,Engineering,Computer Engineering,12,7,5
1982,Engineering,Computer Engineering,338,287,51
1982,Engineering,Computer Engineering,16,11,5
1983,Engineering,Computer Engineering,400,330,70
1983,Engineering,Computer Engineering,7,4,3
1983,Engineering,Computer Engineering,19,14,5
1984,Engineering,Computer Engineering,466,395,71
1984,Engineering,Computer Engineering,4,1,3
1984,Engineering,Computer Engineering,14,12,2
1985,Engineering,Computer Engineering,472,411,61
1985,Engineering,Computer Engineering,6,5,1
1985,Engineering,Computer Engineering,23,20,3
1986,Engineering,Computer Engineering,434,381,53
1986,Engineering,Computer Engineering,5,3,2
1986,Engineering,Computer Engineering,24,23,1
1987,Engineering,Computer Engineering,376,344,32
1987,Engineering,Computer Engineering,4,3,1
1988,Engineering,Computer Engineering,332,299,33
1988,Engineering,Computer Engineering,7,6,1
1988,Engineering,Computer Engineering,29,28,1
1989,Engineering,Computer Engineering,282,260,22
1989,Engineering,Computer Engineering,4,1,3
1989,Engineering,Computer Engineering,27,25,2
1990,Engineering,Computer Engineering,277,249,28
1990,Engineering,Computer Engineering,2,1,1
1990,Engineering,Computer Engineering,22,21,1
1991,Engineering,Computer Engineering,285,262,23
1991,Engineering,Computer Engineering,17,16,1
1992,Engineering,Computer Engineering,308,281,27
1992,Engineering,Computer Engineering,17,16,1
1993,Engineering,Computer Engineering,366,333,33
1993,Engineering,Computer Engineering,17,16,1
1994,Engineering,Computer Engineering,414,377,37
1995,Engineering,Computer Engineering,514,479,35
1995,Engineering,Computer Engineering,20,19,1
1996,Engineering,Computer Engineering,547,512,35
1996,Engineering,Computer Engineering,25,23,2
1997,Engineering,Computer Engineering,561,517,44
1997,Engineering,Computer Engineering,27,25,2
1998,Engineering,Computer Engineering,654,591,63
1998,Engineering,Computer Engineering,25,24,1
1999,Engineering,Computer Engineering,762,683,79
2000,Engineering,Computer Engineering,785,709,76
2001,Engineering,Computer Engineering,837,758,79
2002,Engineering,Computer Engineering,816,729,87
2003,Engineering,Computer Engineering,750,677,73
2006,Fine and Applied Arts,Art and Design,4,1,3
2006,Fine and Applied Arts,Art and Design,2,1,1
2006,Fine and Applied Arts,Art and Design,4,4,0
2006,Fine and Applied Arts,Art and Design,5,4,1
2006,Fine and Applied Arts,Art and Design,7,5,2
2006,Fine and Applied Arts,Art and Design,4,1,3
2006,Fine and Applied Arts,Art and Design,8,4,4
2006,Fine and Applied Arts,Art and Design,6,2,4
2005,Fine and Applied Arts,Art and Design,5,2,3
2005,Fine and Applied Arts,Art and Design,3,3,0
2005,Fine and Applied Arts,Art and Design,6,0,6
2005,Fine and Applied Arts,Art and Design,5,3,2
2005,Fine and Applied Arts,Art and Design,6,3,3
2005,Fine and Applied Arts,Art and Design,6,5,1
2005,Fine and Applied Arts,Art and Design,6,2,4
2005,Fine and Applied Arts,Art and Design,11,7,4
2004,Fine and Applied Arts,Art and Design,6,4,2
1980,LAS,Comparative Literature,42,22,20
1981,LAS,Comparative Literature,44,20,24
1982,LAS,Comparative Literature,43,19,24
1983,LAS,Comparative Literature,39,16,23
1984,LAS,Comparative Literature,36,15,21
1985,LAS,Comparative Literature,45,20,25
1986,LAS,Comparative Literature,33,14,19
1987,LAS,Comparative Literature,33,12,21
1988,LAS,Comparative Literature,28,12,16
1989,LAS,Comparative Literature,29,13,16
1990,LAS,Comparative Literature,33,15,18
1991,LAS,Comparative Literature,35,14,21
1992,LAS,Comparative Literature,34,14,20
1993,LAS,Comparative Literature,32,15,17
1994,LAS,Comparative Literature,30,11,19
1995,LAS,Comparative Literature,31,12,19
1996,LAS,Comparative Literature,32,12,20
1997,LAS,Comparative Literature,36,10,26
1998,LAS,Comparative Literature,27,5,22
1999,LAS,Comparative Literature,21,6,15
2000,LAS,Comparative Literature,23,6,17
2001,LAS,Comparative Literature,27,3,24
2002,LAS,Comparative Literature,28,3,25
2003,LAS,Comparative Literature,24,5,19
1980,Engineering,Computer Science,457,349,108
1980,Engineering,Computer Science,5,4,1
1980,Engineering,Computer Science,18,14,4
1981,Engineering,Computer Science,557,409,148
1981,Engineering,Computer Science,6,4,2
1981,Engineering,Computer Science,20,17,3
1982,Engineering,Computer Science,610,437,173
1982,Engineering,Computer Science,10,6,4
1982,Engineering,Computer Science,28,23,5
1983,Engineering,Computer Science,658,462,196
1983,Engineering,Computer Science,7,5,2
1983,Engineering,Computer Science,19,15,4
1984,Engineering,Computer Science,583,430,153
1984,Engineering,Computer Science,5,4,1
1984,Engineering,Computer Science,12,9,3
1985,Engineering,Computer Science,522,403,119
1985,Engineering,Computer Science,4,3,1
1985,Engineering,Computer Science,12,8,4
1986,Engineering,Computer Science,462,361,101
1986,Engineering,Computer Science,16,12,4
1987,Engineering,Computer Science,410,341,69
1987,Engineering,Computer Science,8,7,1
1987,Engineering,Computer Science,24,18,6
1988,Engineering,Computer Science,417,352,65
1988,Engineering,Computer Science,8,7,1
1988,Engineering,Computer Science,22,18,4
1989,Engineering,Computer Science,385,326,59
1989,Engineering,Computer Science,8,7,1
1989,Engineering,Computer Science,25,21,4
1990,Engineering,Computer Science,368,302,66
1990,Engineering,Computer Science,4,3,1
1990,Engineering,Computer Science,16,14,2
1991,Engineering,Computer Science,369,313,56
1991,Engineering,Computer Science,3,2,1
1991,Engineering,Computer Science,13,12,1
1992,Engineering,Computer Science,379,328,51
1993,Engineering,Computer Science,451,385,66
1993,Engineering,Computer Science,9,8,1
1994,Engineering,Computer Science,526,467,59
1994,Engineering,Computer Science,4,2,2
1994,Engineering,Computer Science,10,8,2
1995,Engineering,Computer Science,577,517,60
1995,Engineering,Computer Science,8,6,2
1995,Engineering,Computer Science,18,17,1
1996,Engineering,Computer Science,609,532,77
1996,Engineering,Computer Science,5,4,1
1996,Engineering,Computer Science,18,17,1
1997,Engineering,Computer Science,661,586,75
1997,Engineering,Computer Science,20,18,2
1998,Engineering,Computer Science,694,614,80
1998,Engineering,Computer Science,12,11,1
1999,Engineering,Computer Science,764,674,90
1999,Engineering,Computer Science,6,4,2
2000,Engineering,Computer Science,770,685,85
2000,Engineering,Computer Science,4,1,3
2000,Engineering,Computer Science,5,4,1
2001,Engineering,Computer Science,876,784,92
2001,Engineering,Computer Science,7,4,3
2002,Engineering,Computer Science,857,769,88
2002,Engineering,Computer Science,12,10,2
2002,Engineering,Computer Science,5,4,1
2003,Engineering,Computer Science,761,680,81
2003,Engineering,Computer Science,14,12,2
2003,Engineering,Computer Science,5,4,1
2004,Fine and Applied Arts,Art and Design,8,2,6
2004,Fine and Applied Arts,Art and Design,5,4,1
2004,Fine and Applied Arts,Art and Design,4,1,3
2004,Fine and Applied Arts,Art and Design,9,5,4
2004,Fine and Applied Arts,Art and Design,6,2,4
2004,Fine and Applied Arts,Art and Design,6,4,2
2004,Fine and Applied Arts,Art and Design,1,1,0
1980,Fine and Applied Arts,Art Education,42,4,38
1980,Fine and Applied Arts,Art Education,30,9,21
1981,Fine and Applied Arts,Art Education,39,3,36
1981,Fine and Applied Arts,Art Education,29,4,25
1982,Fine and Applied Arts,Art Education,37,6,31
1982,Fine and Applied Arts,Art Education,35,7,28
1983,Fine and Applied Arts,Art Education,30,5,25
1983,Fine and Applied Arts,Art Education,44,12,32
1984,Fine and Applied Arts,Art Education,20,4,16
1984,Fine and Applied Arts,Art Education,44,15,29
1985,Fine and Applied Arts,Art Education,22,3,19
1985,Fine and Applied Arts,Art Education,39,13,26
1986,Fine and Applied Arts,Art Education,37,9,28
1986,Fine and Applied Arts,Art Education,33,11,22
1987,Fine and Applied Arts,Art Education,34,4,30
1987,Fine and Applied Arts,Art Education,39,11,28
1988,Fine and Applied Arts,Art Education,38,9,29
1988,Fine and Applied Arts,Art Education,36,6,30
1989,Fine and Applied Arts,Art Education,42,11,31
1989,Fine and Applied Arts,Art Education,35,6,29
1990,Fine and Applied Arts,Art Education,32,15,17
1990,Fine and Applied Arts,Art Education,36,9,27
1991,Fine and Applied Arts,Art Education,45,12,33
1991,Fine and Applied Arts,Art Education,42,12,30
1992,Fine and Applied Arts,Art Education,42,6,36
1992,Fine and Applied Arts,Art Education,37,11,26
1993,Fine and Applied Arts,Art Education,61,13,48
1993,Fine and Applied Arts,Art Education,40,18,22
1994,Fine and Applied Arts,Art Education,55,11,44
1994,Fine and Applied Arts,Art Education,39,14,25
1995,Fine and Applied Arts,Art Education,83,15,68
1995,Fine and Applied Arts,Art Education,43,14,29
1996,Fine and Applied Arts,Art Education,82,20,62
1996,Fine and Applied Arts,Art Education,40,12,28
1997,Fine and Applied Arts,Art Education,70,15,55
1997,Fine and Applied Arts,Art Education,40,8,32
1998,Fine and Applied Arts,Art Education,65,15,50
1998,Fine and Applied Arts,Art Education,36,10,26
1999,Fine and Applied Arts,Art Education,87,19,68
1999,Fine and Applied Arts,Art Education,38,12,26
2000,Fine and Applied Arts,Art Education,76,18,58
2000,Fine and Applied Arts,Art Education,28,5,23
2001,Fine and Applied Arts,Art Education,73,12,61
2001,Fine and Applied Arts,Art Education,27,4,23
2002,Fine and Applied Arts,Art Education,66,8,58
2002,Fine and Applied Arts,Art Education,32,6,26
2003,Fine and Applied Arts,Art Education,72,12,60
2003,Fine and Applied Arts,Art Education,26,4,22
2018,Fine and Applied Arts,Art Education,36,2,34
2018,Fine and Applied Arts,Art Education,4,1,3
2018,Fine and Applied Arts,Art Education,6,0,6
2018,Fine and Applied Arts,Art Education,8,0,8
2017,Fine and Applied Arts,Art Education,32,1,30
2017,Fine and Applied Arts,Art Education,1,0,1
2017,Fine and Applied Arts,Art Education,2,0,2
2017,Fine and Applied Arts,Art Education,6,1,5
2016,Fine and Applied Arts,Art Education,31,3,28
2016,Fine and Applied Arts,Art Education,1,0,1
2016,Fine and Applied Arts,Art Education,2,0,2
2016,Fine and Applied Arts,Art Education,5,1,4
2015,Fine and Applied Arts,Art Education,25,4,21
2015,Fine and Applied Arts,Art Education,2,0,2
2015,Fine and Applied Arts,Art Education,4,1,3
2015,Fine and Applied Arts,Art Education,11,4,7
2014,Fine and Applied Arts,Art Education,30,4,26
2014,Fine and Applied Arts,Art Education,2,0,2
2014,Fine and Applied Arts,Art Education,3,2,1
2014,Fine and Applied Arts,Art Education,14,7,7
2013,Fine and Applied Arts,Art Education,3,1,2
2013,Fine and Applied Arts,Art Education,3,0,3
2013,Fine and Applied Arts,Art Education,13,6,7
2013,Fine and Applied Arts,Art Education,44,8,36
2012,Fine and Applied Arts,Art Education,5,1,4
2012,Fine and Applied Arts,Art Education,14,6,8
2012,Fine and Applied Arts,Art Education,44,9,35
2012,Fine and Applied Arts,Art Education,8,1,7
2011,Fine and Applied Arts,Art Education,5,1,4
2011,Fine and Applied Arts,Art Education,5,0,5
2011,Fine and Applied Arts,Art Education,13,6,7
2003,Business,Computer Science,16,15,1
2003,Business,Computer Science,87,70,17
1981,Business,Computer Science,167,148,19
1982,Business,Computer Science,212,184,28
1983,Business,Computer Science,247,215,32
2003,Business,Computer Science,340,281,59
1980,Business,Computer Science,69,44,25
1981,Business,Computer Science,79,45,34
1982,Business,Computer Science,106,71,35
1983,Business,Computer Science,120,81,39
1984,Business,Computer Science,81,51,30
1985,Business,Computer Science,57,32,25
1986,Business,Computer Science,49,28,21
1987,Business,Computer Science,40,20,20
1988,Business,Computer Science,25,10,15
1989,Business,Computer Science,17,12,5
1990,Business,Computer Science,15,11,4
1991,Business,Computer Science,26,18,8
1992,Business,Computer Science,33,20,13
1993,Business,Computer Science,36,26,10
1994,Business,Computer Science,40,28,12
1995,Business,Computer Science,27,17,10
1996,Business,Computer Science,35,21,14
1997,Business,Computer Science,46,30,16
1998,Business,Computer Science,43,32,11
1999,Business,Computer Science,52,31,21
2000,Business,Computer Science,40,30,10
2001,Business,Computer Science,25,20,5
2002,Business,Computer Science,26,17,9
2003,Business,Computer Science,29,21,8
1980,Business,Computer Science,148,133,15
1984,Business,Computer Science,253,221,32
1985,Business,Computer Science,313,269,44
1986,Business,Computer Science,362,319,43
1987,Business,Computer Science,354,315,39
1988,Business,Computer Science,372,332,40
1989,Business,Computer Science,375,332,43
1990,Business,Computer Science,382,338,44
1991,Business,Computer Science,377,333,44
1992,Business,Computer Science,359,323,36
1993,Business,Computer Science,388,335,53
1994,Business,Computer Science,391,336,55
1995,Business,Computer Science,342,292,50
1996,Business,Computer Science,317,266,51
1997,Business,Computer Science,317,265,52
1998,Business,Computer Science,313,253,60
1999,Business,Computer Science,332,275,57
2000,Business,Computer Science,360,289,71
2001,Business,Computer Science,412,341,71
2002,Business,Computer Science,448,370,78
2011,Fine and Applied Arts,Art Education,59,10,48
2010,Fine and Applied Arts,Art Education,9,1,8
2010,Fine and Applied Arts,Art Education,5,0,5
2010,Fine and Applied Arts,Art Education,12,5,7
2010,Fine and Applied Arts,Art Education,65,12,53
2009,Fine and Applied Arts,Art Education,65,15,50
2009,Fine and Applied Arts,Art Education,14,1,13
2009,Fine and Applied Arts,Art Education,10,3,7
2008,Fine and Applied Arts,Art Education,74,11,63
2008,Fine and Applied Arts,Art Education,19,4,15
2008,Fine and Applied Arts,Art Education,12,3,9
2007,Fine and Applied Arts,Art Education,77,10,67
2007,Fine and Applied Arts,Art Education,16,3,13
2007,Fine and Applied Arts,Art Education,2,0,2
2007,Fine and Applied Arts,Art Education,13,2,11
2006,Fine and Applied Arts,Art Education,79,11,68
2006,Fine and Applied Arts,Art Education,15,5,10
2006,Fine and Applied Arts,Art Education,14,2,12
2005,Fine and Applied Arts,Art Education,78,10,68
2005,Fine and Applied Arts,Art Education,16,5,11
2005,Fine and Applied Arts,Art Education,12,2,10
2004,Fine and Applied Arts,Art Education,74,8,66
2004,Fine and Applied Arts,Art Education,10,3,7
2004,Fine and Applied Arts,Art Education,22,7,15
2018,Fine and Applied Arts,Art Foundation,15,3,12
2017,Fine and Applied Arts,Art Foundation,20,6,14
2016,Fine and Applied Arts,Art Foundation,29,7,22
2015,Fine and Applied Arts,Art Foundation,115,43,72
2014,Fine and Applied Arts,Art Foundation,118,36,82
2013,Fine and Applied Arts,Art Foundation,121,42,79
2012,Fine and Applied Arts,Art Foundation,123,32,91
2011,Fine and Applied Arts,Art Foundation,108,34,74
2010,Fine and Applied Arts,Art Foundation,150,58,92
2009,Fine and Applied Arts,Art Foundation,140,47,93
2008,Fine and Applied Arts,Art Foundation,146,41,105
2007,Fine and Applied Arts,Art Foundation,139,47,92
2006,Fine and Applied Arts,Art Foundation,130,50,80
1980,Fine and Applied Arts,Art History,37,11,26
1981,Fine and Applied Arts,Art History,36,10,26
1982,Fine and Applied Arts,Art History,31,8,23
1983,Fine and Applied Arts,Art History,38,10,28
1984,Fine and Applied Arts,Art History,35,8,27
1985,Fine and Applied Arts,Art History,31,9,22
1986,Fine and Applied Arts,Art History,30,9,21
1987,Fine and Applied Arts,Art History,40,11,29
1988,Fine and Applied Arts,Art History,41,13,28
1989,Fine and Applied Arts,Art History,39,7,32
1990,Fine and Applied Arts,Art History,46,5,41
1991,Fine and Applied Arts,Art History,42,9,33
1992,Fine and Applied Arts,Art History,42,9,33
1993,Fine and Applied Arts,Art History,46,6,40
1994,Fine and Applied Arts,Art History,39,5,34
1995,Fine and Applied Arts,Art History,32,9,23
1996,Fine and Applied Arts,Art History,27,4,23
1997,Fine and Applied Arts,Art History,29,3,26
1998,Fine and Applied Arts,Art History,27,3,24
1999,Fine and Applied Arts,Art History,35,7,28
2000,Fine and Applied Arts,Art History,28,5,23
2001,Fine and Applied Arts,Art History,28,4,24
2002,Fine and Applied Arts,Art History,25,3,22
2003,Fine and Applied Arts,Art History,30,4,26
1980,Fine and Applied Arts,Art History,22,3,19
1981,Fine and Applied Arts,Art History,40,11,29
1982,Fine and Applied Arts,Art History,32,8,24
1983,Fine and Applied Arts,Art History,49,11,38
1984,Fine and Applied Arts,Art History,35,11,24
1985,Fine and Applied Arts,Art History,44,12,32
1986,Fine and Applied Arts,Art History,42,10,32
1987,Fine and Applied Arts,Art History,38,8,30
1988,Fine and Applied Arts,Art History,32,7,25
1989,Fine and Applied Arts,Art History,34,6,28
1990,Fine and Applied Arts,Art History,35,8,27
1991,Fine and Applied Arts,Art History,58,10,48
1992,Fine and Applied Arts,Art History,55,8,47
1993,Fine and Applied Arts,Art History,65,9,56
1994,Fine and Applied Arts,Art History,66,16,50
1995,Fine and Applied Arts,Art History,51,14,37
1996,Fine and Applied Arts,Art History,45,12,33
1997,Fine and Applied Arts,Art History,37,12,25
1998,Fine and Applied Arts,Art History,25,6,19
1999,Fine and Applied Arts,Art History,27,8,19
2000,Fine and Applied Arts,Art History,38,9,29
2001,Fine and Applied Arts,Art History,28,7,21
2002,Fine and Applied Arts,Art History,24,5,19
2003,Fine and Applied Arts,Art History,26,4,22
2018,Fine and Applied Arts,Art History,1,1,0
2018,Fine and Applied Arts,Art History,13,1,12
2017,Fine and Applied Arts,Art History,3,0,3
2017,Fine and Applied Arts,Art History,16,2,14
2016,Fine and Applied Arts,Art History,5,0,5
2016,Fine and Applied Arts,Art History,14,1,13
2015,Fine and Applied Arts,Art History,3,0,3
2015,Fine and Applied Arts,Art History,18,1,17
2014,Fine and Applied Arts,Art History,2,0,2
2014,Fine and Applied Arts,Art History,17,0,17
2013,Fine and Applied Arts,Art History,5,0,5
2013,Fine and Applied Arts,Art History,22,2,20
2012,Fine and Applied Arts,Art History,7,0,7
2012,Fine and Applied Arts,Art History,17,3,14
2011,Fine and Applied Arts,Art History,7,0,7
2011,Fine and Applied Arts,Art History,19,4,15
2010,Fine and Applied Arts,Art History,9,1,8
2010,Fine and Applied Arts,Art History,19,4,15
2009,Fine and Applied Arts,Art History,12,2,10
2009,Fine and Applied Arts,Art History,19,6,13
2008,Fine and Applied Arts,Art History,19,3,16
2008,Fine and Applied Arts,Art History,17,4,13
2007,Fine and Applied Arts,Art History,15,3,12
2007,Fine and Applied Arts,Art History,23,4,19
2006,Fine and Applied Arts,Art History,17,2,15
2006,Fine and Applied Arts,Art History,18,3,15
2005,Fine and Applied Arts,Art History,15,2,13
2005,Fine and Applied Arts,Art History,16,1,15
2004,Fine and Applied Arts,Art History,11,2,9
2004,Fine and Applied Arts,Art History,14,1,13
2018,LAS,Asian American Studies,3,2,1
2017,LAS,Asian American Studies,2,1,1
2013,LAS,Asian Studies,2,2,0
2012,LAS,Asian Studies,6,5,1
2011,LAS,Asian Studies,8,5,3
2010,LAS,Asian Studies,12,6,6
2009,LAS,Asian Studies,10,2,8
2008,LAS,Asian Studies,15,4,11
2007,LAS,Asian Studies,13,3,10
2006,LAS,Asian Studies,10,5,5
2005,LAS,Asian Studies,13,4,9
2004,LAS,Asian Studies,10,2,8
1980,LAS,Asian Studies,17,10,7
1981,LAS,Asian Studies,18,10,8
1982,LAS,Asian Studies,27,8,19
1983,LAS,Asian Studies,20,7,13
1984,LAS,Asian Studies,17,6,11
1985,LAS,Asian Studies,13,9,4
1986,LAS,Asian Studies,13,5,8
1987,LAS,Asian Studies,16,8,8
1988,LAS,Asian Studies,24,10,14
1989,LAS,Asian Studies,33,15,18
1990,LAS,Asian Studies,30,14,16
1991,LAS,Asian Studies,19,4,15
1992,LAS,Asian Studies,34,11,23
1993,LAS,Asian Studies,32,11,21
1994,LAS,Asian Studies,34,14,20
1995,LAS,Asian Studies,31,15,16
1996,LAS,Asian Studies,32,12,20
1997,LAS,Asian Studies,22,8,14
1998,LAS,Asian Studies,27,12,15
1999,LAS,Asian Studies,34,14,20
2000,LAS,Asian Studies,27,8,19
2001,LAS,Asian Studies,18,9,9
2002,LAS,Asian Studies,13,5,8
2003,LAS,Asian Studies,8,3,5
2018,LAS,Astronomy,88,61,27
2018,LAS,Astronomy,1,0,1
2018,LAS,Astronomy,27,15,12
2018,LAS,Astronomy,3,2,1
2017,LAS,Astronomy,76,51,25
2017,LAS,Astronomy,2,0,2
2017,LAS,Astronomy,25,12,13
2017,LAS,Astronomy,1,1,0
2016,LAS,Astronomy,78,51,27
2016,LAS,Astronomy,2,1,1
2016,LAS,Astronomy,25,11,14
2015,LAS,Astronomy,1,1,0
2015,LAS,Astronomy,54,34,20
2015,LAS,Astronomy,27,12,15
2014,LAS,Astronomy,1,0,1
2014,LAS,Astronomy,21,9,12
2014,LAS,Astronomy,55,39,16
2013,LAS,Astronomy,1,1,0
2013,LAS,Astronomy,2,1,1
2013,LAS,Astronomy,1,1,0
2013,LAS,Astronomy,38,26,12
2013,LAS,Astronomy,20,9,11
2012,LAS,Astronomy,1,1,0
2012,LAS,Astronomy,23,14,9
2012,LAS,Astronomy,40,26,14
2011,LAS,Astronomy,1,0,1
2011,LAS,Astronomy,2,1,1
2011,LAS,Astronomy,23,11,12
2011,LAS,Astronomy,38,26,12
2010,LAS,Astronomy,5,4,1
2010,LAS,Astronomy,27,16,11
2010,LAS,Astronomy,42,34,8
2009,LAS,Astronomy,3,3,0
2009,LAS,Astronomy,1,1,0
2009,LAS,Astronomy,38,27,11
2009,LAS,Astronomy,31,20,11
2008,LAS,Astronomy,47,34,13
2008,LAS,Astronomy,28,18,10
2007,LAS,Astronomy,1,0,1
2007,LAS,Astronomy,1,1,0
2007,LAS,Astronomy,37,25,12
2007,LAS,Astronomy,31,18,13
2006,LAS,Astronomy,37,23,14
2006,LAS,Astronomy,27,15,12
2005,LAS,Astronomy,41,26,15
2005,LAS,Astronomy,31,17,14
2004,LAS,Astronomy,41,20,21
2004,LAS,Astronomy,29,16,13
1980,LAS,Astronomy,16,13,3
1981,LAS,Astronomy,15,13,2
1982,LAS,Astronomy,15,14,1
1983,LAS,Astronomy,17,15,2
1984,LAS,Astronomy,18,16,2
1985,LAS,Astronomy,19,16,3
1986,LAS,Astronomy,19,16,3
1987,LAS,Astronomy,20,18,2
1988,LAS,Astronomy,19,16,3
1989,LAS,Astronomy,15,13,2
1990,LAS,Astronomy,16,13,3
1991,LAS,Astronomy,18,14,4
1992,LAS,Astronomy,20,14,6
1993,LAS,Astronomy,20,14,6
1994,LAS,Astronomy,22,17,5
1995,LAS,Astronomy,18,13,5
1996,LAS,Astronomy,22,15,7
1997,LAS,Astronomy,18,12,6
1998,LAS,Astronomy,21,15,6
1999,LAS,Astronomy,28,20,8
2000,LAS,Astronomy,22,15,7
2001,LAS,Astronomy,22,16,6
2002,LAS,Astronomy,29,19,10
2003,LAS,Astronomy,26,16,10
2012,Applied Health Sciences,Athletic Training,1,0,1
2011,Applied Health Sciences,Athletic Training,17,5,12
2010,Applied Health Sciences,Athletic Training,34,9,25
2009,Applied Health Sciences,Athletic Training,29,10,19
2018,LAS,Atmospheric Sciences,70,44,26
2018,LAS,Atmospheric Sciences,1,0,1
2018,LAS,Atmospheric Sciences,12,8,4
2018,LAS,Atmospheric Sciences,32,23,9
2018,LAS,Atmospheric Sciences,2,2,0
2017,LAS,Atmospheric Sciences,69,39,30
2017,LAS,Atmospheric Sciences,22,17,5
2017,LAS,Atmospheric Sciences,27,18,9
2017,LAS,Atmospheric Sciences,1,1,0
2016,LAS,Atmospheric Sciences,59,35,24
2016,LAS,Atmospheric Sciences,1,1,0
2016,LAS,Atmospheric Sciences,25,21,4
2016,LAS,Atmospheric Sciences,23,15,8
2015,LAS,Atmospheric Sciences,3,2,1
2015,LAS,Atmospheric Sciences,62,34,28
2015,LAS,Atmospheric Sciences,19,17,2
2015,LAS,Atmospheric Sciences,27,12,15
2014,LAS,Atmospheric Sciences,2,2,0
2014,LAS,Atmospheric Sciences,73,45,28
2014,LAS,Atmospheric Sciences,15,12,3
2014,LAS,Atmospheric Sciences,31,15,16
2013,LAS,Atmospheric Sciences,2,0,2
2013,LAS,Atmospheric Sciences,16,10,6
2013,LAS,Atmospheric Sciences,30,16,14
2013,LAS,Atmospheric Sciences,68,47,21
2012,LAS,Atmospheric Sciences,16,6,10
2012,LAS,Atmospheric Sciences,29,14,15
2012,LAS,Atmospheric Sciences,72,50,22
2011,LAS,Atmospheric Sciences,1,1,0
2011,LAS,Atmospheric Sciences,22,10,12
2011,LAS,Atmospheric Sciences,28,15,13
2011,LAS,Atmospheric Sciences,76,49,27
2010,LAS,Atmospheric Sciences,1,1,0
2010,LAS,Atmospheric Sciences,22,11,11
2010,LAS,Atmospheric Sciences,28,14,14
2010,LAS,Atmospheric Sciences,77,51,26
2009,LAS,Atmospheric Sciences,1,1,0
2009,LAS,Atmospheric Sciences,62,38,24
2009,LAS,Atmospheric Sciences,26,13,13
2009,LAS,Atmospheric Sciences,27,13,14
2008,LAS,Atmospheric Sciences,41,27,13
2008,LAS,Atmospheric Sciences,22,12,10
2008,LAS,Atmospheric Sciences,23,13,10
2007,LAS,Atmospheric Sciences,19,12,7
2007,LAS,Atmospheric Sciences,28,15,13
2006,LAS,Atmospheric Sciences,16,10,6
2006,LAS,Atmospheric Sciences,22,15,7
2005,LAS,Atmospheric Sciences,19,11,8
2005,LAS,Atmospheric Sciences,18,15,3
2004,LAS,Atmospheric Sciences,18,11,7
2004,LAS,Atmospheric Sciences,23,17,6
1980,LAS,Atmospheric Sciences,22,17,5
1981,LAS,Atmospheric Sciences,22,17,5
1982,LAS,Atmospheric Sciences,23,17,6
1983,LAS,Atmospheric Sciences,21,14,7
1984,LAS,Atmospheric Sciences,22,16,6
1985,LAS,Atmospheric Sciences,24,18,6
1986,LAS,Atmospheric Sciences,28,22,6
1987,LAS,Atmospheric Sciences,24,19,5
1988,LAS,Atmospheric Sciences,24,19,5
1989,LAS,Atmospheric Sciences,28,23,5
1990,LAS,Atmospheric Sciences,23,18,5
1991,LAS,Atmospheric Sciences,26,22,4
1992,LAS,Atmospheric Sciences,36,30,6
1993,LAS,Atmospheric Sciences,38,33,5
1994,LAS,Atmospheric Sciences,27,25,2
1995,LAS,Atmospheric Sciences,32,24,8
1996,LAS,Atmospheric Sciences,29,20,9
1997,LAS,Atmospheric Sciences,33,23,10
1998,LAS,Atmospheric Sciences,27,17,10
1999,LAS,Atmospheric Sciences,31,17,14
2000,LAS,Atmospheric Sciences,27,15,12
2001,LAS,Atmospheric Sciences,30,17,13
2002,LAS,Atmospheric Sciences,37,23,14
2003,LAS,Atmospheric Sciences,41,26,15
2018,Applied Health Sciences,Audiology,26,2,23
2017,Applied Health Sciences,Audiology,26,4,22
2016,Applied Health Sciences,Audiology,29,4,25
2015,Applied Health Sciences,Audiology,28,4,24
2014,Applied Health Sciences,Audiology,25,4,21
2013,Applied Health Sciences,Audiology,19,1,18
2012,Applied Health Sciences,Audiology,16,3,13
2011,Applied Health Sciences,Audiology,18,5,13
2010,Applied Health Sciences,Audiology,21,5,16
2009,Applied Health Sciences,Audiology,19,5,14
2008,Applied Health Sciences,Audiology,19,3,16
2007,Applied Health Sciences,Audiology,11,0,11
2006,Applied Health Sciences,Audiology,7,0,7
2005,Applied Health Sciences,Audiology,4,0,4
2004,Applied Health Sciences,Audiology,5,0,5
2000,Aviation,Aviation Human Factors,75,67,8
2001,Aviation,Aviation Human Factors,160,140,20
2002,Aviation,Aviation Human Factors,188,171,17
2003,Aviation,Aviation Human Factors,175,162,13
2014,Aviation,Aviation Human Factors,3,3,0
2013,Aviation,Aviation Human Factors,28,22,6
2012,Aviation,Aviation Human Factors,39,36,3
2011,Aviation,Aviation Human Factors,70,65,5
2010,Aviation,Aviation Human Factors,101,94,7
2009,Aviation,Aviation Human Factors,128,118,10
2008,Aviation,Aviation Human Factors,140,127,13
2007,Aviation,Aviation Human Factors,163,149,14
2006,Aviation,Aviation Human Factors,164,148,16
2005,Aviation,Aviation Human Factors,183,168,15
2004,Aviation,Aviation Human Factors,189,177,12
1984,Aviation,Avionics,11,10,1
1987,Aviation,Avionics,3,2,1
1984,LAS,BIOCH,114,70,44
1985,LAS,BIOCH,124,69,55
1986,LAS,BIOCH,153,91,62
1987,LAS,BIOCH,170,91,79
1988,LAS,BIOCH,164,87,77
1989,LAS,BIOCH,173,106,67
1990,LAS,BIOCH,161,101,60
1991,LAS,BIOCH,148,86,62
1992,LAS,BIOCH,145,81,64
1993,LAS,BIOCH,161,83,78
1994,LAS,BIOCH,201,116,85
1995,LAS,BIOCH,211,115,96
1996,LAS,BIOCH,225,130,95
1997,LAS,BIOCH,200,103,97
1998,LAS,BIOCH,210,111,99
1999,LAS,BIOCH,180,83,97
2000,LAS,BIOCH,156,86,70
2001,LAS,BIOCH,156,85,71
2002,LAS,BIOCH,159,82,77
2003,LAS,BIOCH,169,78,91
2018,LAS,Biochemistry,169,84,85
2018,LAS,Biochemistry,1,0,1
2018,LAS,Biochemistry,1,1,0
2018,LAS,Biochemistry,71,39,32
2017,LAS,Biochemistry,176,88,88
2017,LAS,Biochemistry,1,1,0
2017,LAS,Biochemistry,63,33,30
2016,LAS,Biochemistry,172,85,87
2016,LAS,Biochemistry,64,38,26
2015,LAS,Biochemistry,1,1,0
2015,LAS,Biochemistry,67,40,27
2015,LAS,Biochemistry,166,86,80
2014,LAS,Biochemistry,140,83,57
2014,LAS,Biochemistry,79,43,36
2013,LAS,Biochemistry,63,35,28
2013,LAS,Biochemistry,162,105,57
2012,LAS,Biochemistry,64,35,29
2012,LAS,Biochemistry,160,104,56
2011,LAS,Biochemistry,1,0,1
2011,LAS,Biochemistry,1,0,1
2011,LAS,Biochemistry,65,32,33
2011,LAS,Biochemistry,141,84,57
2010,LAS,Biochemistry,1,0,1
2010,LAS,Biochemistry,1,1,0
2010,LAS,Biochemistry,63,33,30
2010,LAS,Biochemistry,139,73,66
2009,LAS,Biochemistry,1,1,0
2009,LAS,Biochemistry,140,76,64
2009,LAS,Biochemistry,61,31,30
2008,LAS,Biochemistry,1,0,1
2008,LAS,Biochemistry,1,1,0
2008,LAS,Biochemistry,131,82,49
2008,LAS,Biochemistry,71,39,32
2007,LAS,Biochemistry,1,1,0
2007,LAS,Biochemistry,1,1,0
2007,LAS,Biochemistry,1,0,1
2007,LAS,Biochemistry,174,98,76
2007,LAS,Biochemistry,83,44,39
2006,LAS,Biochemistry,2,2,0
2006,LAS,Biochemistry,1,0,1
2006,LAS,Biochemistry,235,120,115
2006,LAS,Biochemistry,79,48,31
2005,LAS,Biochemistry,2,0,2
2005,LAS,Biochemistry,16,9,7
2005,LAS,Biochemistry,266,139,126
2005,LAS,Biochemistry,93,54,39
2004,LAS,Biochemistry,178,81,96
2004,LAS,Biochemistry,58,34,24
2004,LAS,Biochemistry,2,0,2
2004,LAS,Biochemistry,1,1,0
2004,LAS,Biochemistry,90,46,44
1980,LAS,Biochemistry,86,66,20
1981,LAS,Biochemistry,84,59,25
1982,LAS,Biochemistry,82,54,28
1983,LAS,Biochemistry,97,67,30
1984,LAS,Biochemistry,94,64,30
1985,LAS,Biochemistry,112,76,36
1986,LAS,Biochemistry,109,73,36
1987,LAS,Biochemistry,119,77,42
1988,LAS,Biochemistry,115,72,43
1989,LAS,Biochemistry,112,67,45
1990,LAS,Biochemistry,99,56,43
1991,LAS,Biochemistry,102,63,39
1992,LAS,Biochemistry,103,62,41
1993,LAS,Biochemistry,95,56,39
1994,LAS,Biochemistry,88,52,36
1995,LAS,Biochemistry,95,50,45
1996,LAS,Biochemistry,95,51,44
1997,LAS,Biochemistry,83,48,35
1998,LAS,Biochemistry,80,42,38
1999,LAS,Biochemistry,77,45,32
2000,LAS,Biochemistry,84,49,35
2001,LAS,Biochemistry,87,51,36
2002,LAS,Biochemistry,80,49,31
2003,LAS,Biochemistry,81,47,34
2017,ACES,Bioenergy,2,2,0
2016,ACES,Bioenergy,11,6,5
2015,ACES,Bioenergy,19,12,7
2014,ACES,Bioenergy,1,1,0
2014,ACES,Bioenergy,16,14,2
2013,ACES,Bioenergy,10,7,3
2012,ACES,Bioenergy,9,7,2
2011,ACES,Bioenergy,12,10,2
2010,ACES,Bioenergy,12,10,2
2009,ACES,Bioenergy,6,6,0
2018,Engineering,Bioengineering,266,129,137
2018,Engineering,Bioengineering,20,11,9
2018,Engineering,Bioengineering,1,0,1
2018,Engineering,Bioengineering,8,6,2
2018,Engineering,Bioengineering,5,2,3
2018,Engineering,Bioengineering,80,46,34
2018,Engineering,Bioengineering,2,0,2
2018,Engineering,Bioengineering,1,0,1
2017,Engineering,Bioengineering,259,126,133
2017,Engineering,Bioengineering,11,7,4
2017,Engineering,Bioengineering,8,4,4
2017,Engineering,Bioengineering,10,6,4
2017,Engineering,Bioengineering,8,6,2
2017,Engineering,Bioengineering,71,38,33
2017,Engineering,Bioengineering,2,0,2
2016,Engineering,Bioengineering,274,143,131
2016,Engineering,Bioengineering,17,14,3
2016,Engineering,Bioengineering,58,33,25
2015,Engineering,Bioengineering,12,7,5
2015,Engineering,Bioengineering,249,130,119
2015,Engineering,Bioengineering,57,30,27
2014,Engineering,Bioengineering,7,5,2
2014,Engineering,Bioengineering,246,134,112
2014,Engineering,Bioengineering,67,35,32
2013,Engineering,Bioengineering,7,6,1
2013,Engineering,Bioengineering,61,31,30
2013,Engineering,Bioengineering,208,115,93
2012,Engineering,Bioengineering,10,6,4
2012,Engineering,Bioengineering,187,106,81
2012,Engineering,Bioengineering,62,33,29
2011,Engineering,Bioengineering,178,103,75
2011,Engineering,Bioengineering,6,3,3
2011,Engineering,Bioengineering,47,28,19
2010,Engineering,Bioengineering,158,99,59
2010,Engineering,Bioengineering,5,3,2
2010,Engineering,Bioengineering,37,24,13
2009,Engineering,Bioengineering,6,4,2
2009,Engineering,Bioengineering,140,83,57
2009,Engineering,Bioengineering,32,18,14
2008,Engineering,Bioengineering,4,3,1
2008,Engineering,Bioengineering,135,77,58
2008,Engineering,Bioengineering,34,21,13
2007,Engineering,Bioengineering,6,2,4
2007,Engineering,Bioengineering,107,64,43
2007,Engineering,Bioengineering,23,13,10
2006,Engineering,Bioengineering,5,2,3
2006,Engineering,Bioengineering,80,51,29
2006,Engineering,Bioengineering,16,7,9
2005,Engineering,Bioengineering,2,1,1
2005,Engineering,Bioengineering,52,37,15
2005,Engineering,Bioengineering,6,2,4
2004,Engineering,Bioengineering,22,18,4
2004,Engineering,Bioengineering,1,0,1
2004,Engineering,Bioengineering,1,0,1
2009,LAS,Bioengineering,1,1,0
2007,LAS,Bioengineering,1,0,1
2005,LAS,Bioengineering,1,1,0
2004,LAS,Bioengineering,14,10,4
2018,ACES,Bioinformatics,4,3,1
2017,ACES,Bioinformatics,3,3,0
2016,ACES,Bioinformatics,1,0,1
2016,ACES,Bioinformatics,3,3,0
2015,ACES,Bioinformatics,1,0,1
2015,ACES,Bioinformatics,1,1,0
2014,ACES,Bioinformatics,1,0,1
2014,ACES,Bioinformatics,2,2,0
2013,ACES,Bioinformatics,4,1,3
2012,ACES,Bioinformatics,1,1,0
2012,ACES,Bioinformatics,6,2,4
2011,ACES,Bioinformatics,4,4,0
2011,ACES,Bioinformatics,6,4,2
2010,ACES,Bioinformatics,4,4,0
2010,ACES,Bioinformatics,6,5,1
2009,ACES,Bioinformatics,3,2,1
2008,ACES,Bioinformatics,1,1,0
2018,Engineering,Bioinformatics,6,4,2
2017,Engineering,Bioinformatics,6,5,1
2016,Engineering,Bioinformatics,5,4,1
2015,Engineering,Bioinformatics,5,2,3
2014,Engineering,Bioinformatics,3,1,2
2013,Engineering,Bioinformatics,3,2,1
2012,Engineering,Bioinformatics,2,2,0
2011,Engineering,Bioinformatics,2,1,1
2010,Engineering,Bioinformatics,3,2,1
2009,Engineering,Bioinformatics,4,2,2
2007,Engineering,Bioinformatics,4,2,2
2006,Engineering,Bioinformatics,4,2,2
2018,iSchool,Bioinformatics,4,3,1
2017,iSchool,Bioinformatics,1,0,1
2016,iSchool,Bioinformatics,1,0,1
2015,iSchool,Bioinformatics,3,0,3
2014,iSchool,Bioinformatics,2,0,2
2013,iSchool,Bioinformatics,2,0,2
2012,iSchool,Bioinformatics,2,2,0
2011,iSchool,Bioinformatics,3,3,0
2010,iSchool,Bioinformatics,2,1,1
2009,iSchool,Bioinformatics,3,1,2
2008,iSchool,Bioinformatics,6,2,4
2010,LAS,Bioinformatics,1,1,0
2017,Engineering,Bioinstrumentation,1,1,0
2016,Engineering,Bioinstrumentation,16,10,6
2015,Engineering,Bioinstrumentation,12,7,5
1980,Applied Health Sciences,Biology,19,10,9
1981,Applied Health Sciences,Biology,30,11,19
1982,Applied Health Sciences,Biology,30,9,21
1983,Applied Health Sciences,Biology,35,15,20
1984,Applied Health Sciences,Biology,59,26,33
1985,Applied Health Sciences,Biology,80,30,50
1986,Applied Health Sciences,Biology,88,39,49
1987,Applied Health Sciences,Biology,80,32,48
1988,Applied Health Sciences,Biology,94,40,54
1989,Applied Health Sciences,Biology,115,60,55
1990,Applied Health Sciences,Biology,102,50,52
1991,Applied Health Sciences,Biology,109,62,47
1992,Applied Health Sciences,Biology,119,66,53
1993,Applied Health Sciences,Biology,70,40,30
1994,Applied Health Sciences,Biology,24,13,11
1995,Applied Health Sciences,Biology,3,2,1
1996,Applied Health Sciences,Biology,2,1,1
2018,LAS,Biology,1,0,1
2018,LAS,Biology,3,2,1
2018,LAS,Biology,16,10,6
2018,LAS,Biology,2,1,1
2018,LAS,Biology,3,2,1
2018,LAS,Biology,695,265,430
2017,LAS,Biology,1,1,0
2017,LAS,Biology,14,9,5
2017,LAS,Biology,1,0,1
2017,LAS,Biology,4,1,3
2017,LAS,Biology,676,254,422
2016,LAS,Biology,4,1,3
2016,LAS,Biology,11,8,3
2016,LAS,Biology,1,1,0
2016,LAS,Biology,1,0,1
2016,LAS,Biology,706,268,438
2015,LAS,Biology,4,1,3
2015,LAS,Biology,8,5,3
2015,LAS,Biology,5,2,3
2015,LAS,Biology,1,1,0
2015,LAS,Biology,712,293,419
2014,LAS,Biology,1,0,1
2014,LAS,Biology,3,2,1
2014,LAS,Biology,4,2,2
2014,LAS,Biology,13,8,5
2014,LAS,Biology,6,3,3
2014,LAS,Biology,680,290,390
2013,LAS,Biology,10,8,2
2013,LAS,Biology,7,5,2
2013,LAS,Biology,11,7,4
2013,LAS,Biology,1,0,1
2013,LAS,Biology,1,0,1
2013,LAS,Biology,5,3,2
2013,LAS,Biology,3,2,1
2013,LAS,Biology,581,258,323
2012,LAS,Biology,1,1,0
2012,LAS,Biology,4,2,2
2012,LAS,Biology,1,1,0
2012,LAS,Biology,12,7,5
2012,LAS,Biology,2,0,2
2012,LAS,Biology,2,1,1
2012,LAS,Biology,13,8,5
2012,LAS,Biology,9,3,6
2012,LAS,Biology,2,1,1
2012,LAS,Biology,651,280,371
2011,LAS,Biology,2,1,1
2011,LAS,Biology,14,7,7
2011,LAS,Biology,5,0,5
2011,LAS,Biology,3,2,1
2011,LAS,Biology,14,9,5
2011,LAS,Biology,8,4,4
2011,LAS,Biology,770,324,446
2010,LAS,Biology,2,0,2
2010,LAS,Biology,15,6,9
2010,LAS,Biology,8,2,6
2010,LAS,Biology,7,4,3
2010,LAS,Biology,21,15,6
2010,LAS,Biology,2,1,1
2010,LAS,Biology,8,3,5
2010,LAS,Biology,721,349,372
2009,LAS,Biology,1,1,0
2009,LAS,Biology,12,3,9
2009,LAS,Biology,10,6,4
2009,LAS,Biology,36,21,15
2009,LAS,Biology,14,6,8
2009,LAS,Biology,9,5,4
2009,LAS,Biology,2,1,1
2009,LAS,Biology,727,336,390
2008,LAS,Biology,1,1,0
2008,LAS,Biology,12,4,8
2008,LAS,Biology,13,8,5
2008,LAS,Biology,14,7,7
2008,LAS,Biology,34,14,20
2008,LAS,Biology,15,8,7
2008,LAS,Biology,787,347,440
2007,LAS,Biology,4,3,1
2007,LAS,Biology,27,7,20
2007,LAS,Biology,15,8,7
2007,LAS,Biology,13,6,7
2007,LAS,Biology,30,11,19
2007,LAS,Biology,1,0,1
2007,LAS,Biology,2,1,1
2007,LAS,Biology,1,0,1
2007,LAS,Biology,1,1,0
2007,LAS,Biology,26,6,20
2007,LAS,Biology,788,346,439
2006,LAS,Biology,2,1,1
2006,LAS,Biology,19,10,9
2006,LAS,Biology,6,1,5
2006,LAS,Biology,25,11,14
2006,LAS,Biology,20,10,10
2006,LAS,Biology,1,0,1
2006,LAS,Biology,1,0,1
2006,LAS,Biology,3,1,2
2006,LAS,Biology,1,1,0
2006,LAS,Biology,1,1,0
2006,LAS,Biology,19,5,14
2006,LAS,Biology,697,305,390
2005,LAS,Biology,4,2,2
2005,LAS,Biology,25,12,13
2005,LAS,Biology,7,4,3
2005,LAS,Biology,19,10,9
2005,LAS,Biology,32,18,14
2005,LAS,Biology,6,2,4
2005,LAS,Biology,1,0,1
2005,LAS,Biology,9,6,3
2005,LAS,Biology,1,0,1
2005,LAS,Biology,4,2,2
2005,LAS,Biology,21,10,11
2005,LAS,Biology,940,429,510
2004,LAS,Biology,19,10,9
2004,LAS,Biology,7,4,3
2004,LAS,Biology,5,4,1
2004,LAS,Biology,32,16,16
2004,LAS,Biology,20,9,11
2004,LAS,Biology,62,24,38
2004,LAS,Biology,63,28,35
2004,LAS,Biology,4,3,1
2004,LAS,Biology,997,430,565
2000,LAS,Biology,13,4,9
2001,LAS,Biology,25,10,15
2002,LAS,Biology,33,14,19
2003,LAS,Biology,36,17,19
2000,LAS,Biology,22,15,7
2001,LAS,Biology,20,11,9
2002,LAS,Biology,14,8,6
2003,LAS,Biology,8,6,2
2000,LAS,Biology,8,5,3
2001,LAS,Biology,11,6,5
2002,LAS,Biology,16,9,7
2003,LAS,Biology,18,9,9
1980,LAS,Biology,139,83,56
1981,LAS,Biology,161,91,70
1982,LAS,Biology,175,92,83
1983,LAS,Biology,182,106,76
1984,LAS,Biology,175,94,81
1985,LAS,Biology,167,87,80
1986,LAS,Biology,163,87,76
1987,LAS,Biology,139,67,72
1988,LAS,Biology,133,71,62
1989,LAS,Biology,138,75,63
1990,LAS,Biology,141,92,49
1991,LAS,Biology,153,96,57
1992,LAS,Biology,159,91,68
1993,LAS,Biology,200,121,79
1994,LAS,Biology,152,84,68
1995,LAS,Biology,136,73,63
1996,LAS,Biology,127,69,58
1997,LAS,Biology,114,62,52
1998,LAS,Biology,103,63,40
1999,LAS,Biology,59,34,25
2000,LAS,Biology,27,16,11
2001,LAS,Biology,26,10,16
2002,LAS,Biology,24,9,15
2003,LAS,Biology,22,10,12
2001,LAS,Biology,136,43,93
2002,LAS,Biology,192,69,123
2003,LAS,Biology,158,67,91
2001,LAS,Biology,165,66,99
2002,LAS,Biology,483,203,280
2003,LAS,Biology,598,257,341
2004,LAS,Biophysics,1,1,0
2018,LAS,Biophysics & Computnl Biology,12,9,3
2017,LAS,Biophysics & Computnl Biology,16,11,5
2016,LAS,Biophysics & Computnl Biology,28,21,7
2015,LAS,Biophysics & Computnl Biology,46,37,9
2014,LAS,Biophysics & Computnl Biology,54,41,13
2013,LAS,Biophysics & Computnl Biology,54,41,13
2012,LAS,Biophysics & Computnl Biology,67,53,14
2011,LAS,Biophysics & Computnl Biology,70,55,15
2010,LAS,Biophysics & Computnl Biology,65,53,12
2009,LAS,Biophysics & Computnl Biology,1,1,0
2009,LAS,Biophysics & Computnl Biology,69,54,15
2008,LAS,Biophysics & Computnl Biology,3,2,1
2008,LAS,Biophysics & Computnl Biology,72,54,18
2007,LAS,Biophysics & Computnl Biology,67,48,19
2006,LAS,Biophysics & Computnl Biology,59,44,15
2005,LAS,Biophysics & Computnl Biology,68,47,21
2004,LAS,Biophysics & Computnl Biology,1,1,0
2004,LAS,Biophysics & Computnl Biology,70,48,22
1980,LAS,Biophysics & Computnl Biology,21,18,3
1981,LAS,Biophysics & Computnl Biology,25,19,6
1982,LAS,Biophysics & Computnl Biology,26,20,6
1983,LAS,Biophysics & Computnl Biology,26,19,7
1984,LAS,Biophysics & Computnl Biology,29,22,7
1985,LAS,Biophysics & Computnl Biology,31,26,5
1986,LAS,Biophysics & Computnl Biology,34,27,7
1987,LAS,Biophysics & Computnl Biology,34,28,6
1988,LAS,Biophysics & Computnl Biology,37,32,5
1989,LAS,Biophysics & Computnl Biology,43,34,9
1990,LAS,Biophysics & Computnl Biology,45,30,15
1991,LAS,Biophysics & Computnl Biology,47,29,18
1992,LAS,Biophysics & Computnl Biology,49,29,20
1993,LAS,Biophysics & Computnl Biology,52,31,21
1994,LAS,Biophysics & Computnl Biology,44,28,16
1995,LAS,Biophysics & Computnl Biology,50,32,18
1996,LAS,Biophysics & Computnl Biology,39,24,15
1997,LAS,Biophysics & Computnl Biology,48,32,16
1998,LAS,Biophysics & Computnl Biology,44,28,16
1999,LAS,Biophysics & Computnl Biology,49,34,15
2000,LAS,Biophysics & Computnl Biology,53,38,15
2001,LAS,Biophysics & Computnl Biology,56,41,15
2002,LAS,Biophysics & Computnl Biology,54,40,14
2003,LAS,Biophysics & Computnl Biology,67,47,20
2018,LAS,Biophysics & Quant Biology,43,32,11
2018,LAS,Biophysics & Quant Biology,3,1,2
2017,LAS,Biophysics & Quant Biology,32,26,6
2017,LAS,Biophysics & Quant Biology,1,0,1
2016,LAS,Biophysics & Quant Biology,19,14,5
2016,LAS,Biophysics & Quant Biology,1,0,1
2015,LAS,Biophysics & Quant Biology,8,3,5
2018,ACES,Bioprocessing and Bioenergy,10,6,4
2017,ACES,Bioprocessing and Bioenergy,4,3,1
2018,Media,Broadcast Journalism,1,0,1
2017,Media,Broadcast Journalism,12,8,4
2016,Media,Broadcast Journalism,58,24,34
2015,Media,Broadcast Journalism,100,35,65
2014,Media,Broadcast Journalism,144,51,93
2013,Media,Broadcast Journalism,179,61,118
2012,Media,Broadcast Journalism,149,57,92
2011,Media,Broadcast Journalism,157,55,102
2010,Media,Broadcast Journalism,136,41,95
2009,Media,Broadcast Journalism,154,42,112
2008,Media,Broadcast Journalism,138,38,100
2007,Media,Broadcast Journalism,75,25,50
2006,Media,Broadcast Journalism,84,32,52
2005,Media,Broadcast Journalism,79,30,49
2004,Media,Broadcast Journalism,68,27,41
1981,Media,Broadcast Journalism,38,17,21
1982,Media,Broadcast Journalism,39,18,21
1983,Media,Broadcast Journalism,47,21,26
1984,Media,Broadcast Journalism,41,14,27
1985,Media,Broadcast Journalism,49,10,39
1986,Media,Broadcast Journalism,50,10,40
1987,Media,Broadcast Journalism,46,10,36
1988,Media,Broadcast Journalism,54,10,44
1989,Media,Broadcast Journalism,65,14,51
1990,Media,Broadcast Journalism,56,21,35
1991,Media,Broadcast Journalism,49,18,31
1992,Media,Broadcast Journalism,68,16,52
1993,Media,Broadcast Journalism,68,21,47
1994,Media,Broadcast Journalism,70,24,46
1995,Media,Broadcast Journalism,72,30,42
1996,Media,Broadcast Journalism,78,28,50
1997,Media,Broadcast Journalism,76,22,54
1998,Media,Broadcast Journalism,81,23,58
1999,Media,Broadcast Journalism,77,20,57
2000,Media,Broadcast Journalism,67,18,49
2001,Media,Broadcast Journalism,76,21,55
2002,Media,Broadcast Journalism,75,22,53
2003,Media,Broadcast Journalism,63,22,41
1980,Education,BUS EDUC,33,13,20
1981,Education,BUS EDUC,25,3,22
1982,Education,BUS EDUC,31,5,26
1983,Education,BUS EDUC,36,8,28
1984,Education,BUS EDUC,34,11,23
1985,Education,BUS EDUC,29,5,24
1986,Education,BUS EDUC,21,3,18
1987,Education,BUS EDUC,13,2,11
1988,Education,BUS EDUC,13,4,9
1989,Education,BUS EDUC,19,5,14
1990,Education,BUS EDUC,16,7,9
1991,Education,BUS EDUC,12,5,7
1992,Education,BUS EDUC,9,4,5
1993,Education,BUS EDUC,4,3,1
2003,Business,BUS NON-DEGREE,46,25,21
1981,Business,Business Administration,436,307,129
1982,Business,Business Administration,377,267,110
1983,Business,Business Administration,345,258,87
2003,Business,Business Administration,390,138,252
2003,Business,Business Administration,86,26,60
2003,Business,Business Administration,39,31,8
2003,Business,Business Administration,157,108,49
2003,Business,Business Administration,67,49,18
2003,Business,Business Administration,3,1,2
2003,Business,Business Administration,326,229,97
2003,Business,Business Administration,48,24,24
2003,Business,Business Administration,35,23,12
1981,Business,Business Administration,851,429,422
1982,Business,Business Administration,770,374,396
1983,Business,Business Administration,686,315,371
1980,Business,Business Administration,409,302,107
1984,Business,Business Administration,339,244,95
1985,Business,Business Administration,315,229,86
1985,Business,Business Administration,60,39,21
1986,Business,Business Administration,334,242,92
1986,Business,Business Administration,65,44,21
1987,Business,Business Administration,330,248,82
1987,Business,Business Administration,75,52,23
1988,Business,Business Administration,344,255,89
1988,Business,Business Administration,99,77,22
1989,Business,Business Administration,381,272,109
1989,Business,Business Administration,124,96,28
1990,Business,Business Administration,389,291,98
1990,Business,Business Administration,126,86,40
1991,Business,Business Administration,421,320,101
1991,Business,Business Administration,135,92,43
1992,Business,Business Administration,202,89,113
1992,Business,Business Administration,469,255,214
1992,Business,Business Administration,3,2,1
1992,Business,Business Administration,570,414,156
1992,Business,Business Administration,128,88,40
1993,Business,Business Administration,239,107,132
1993,Business,Business Administration,334,182,152
1993,Business,Business Administration,5,4,1
1993,Business,Business Administration,27,13,14
1993,Business,Business Administration,19,17,2
1993,Business,Business Administration,553,388,165
1993,Business,Business Administration,119,79,40
1994,Business,Business Administration,259,122,137
1994,Business,Business Administration,202,101,101
1994,Business,Business Administration,7,5,2
1994,Business,Business Administration,15,10,5
1994,Business,Business Administration,40,21,19
1994,Business,Business Administration,30,26,4
1994,Business,Business Administration,557,406,151
1994,Business,Business Administration,104,73,31
1995,Business,Business Administration,307,125,182
1995,Business,Business Administration,137,61,76
1995,Business,Business Administration,31,14,17
1995,Business,Business Administration,64,31,33
1995,Business,Business Administration,42,31,11
1995,Business,Business Administration,5,2,3
1995,Business,Business Administration,605,438,167
1995,Business,Business Administration,92,65,27
1996,Business,Business Administration,372,156,216
1996,Business,Business Administration,110,45,65
1996,Business,Business Administration,2,1,1
1996,Business,Business Administration,30,18,12
1996,Business,Business Administration,99,51,48
1996,Business,Business Administration,49,37,12
1996,Business,Business Administration,3,2,1
1996,Business,Business Administration,626,434,192
1996,Business,Business Administration,105,72,33
1997,Business,Business Administration,404,169,235
1997,Business,Business Administration,79,26,53
1997,Business,Business Administration,3,1,2
1997,Business,Business Administration,27,17,10
1997,Business,Business Administration,136,81,55
1997,Business,Business Administration,38,29,9
1997,Business,Business Administration,6,4,2
1997,Business,Business Administration,591,399,192
1997,Business,Business Administration,97,59,38
1998,Business,Business Administration,394,157,237
1998,Business,Business Administration,93,36,57
1998,Business,Business Administration,4,2,2
1998,Business,Business Administration,29,21,8
1998,Business,Business Administration,228,148,80
1998,Business,Business Administration,40,33,7
1998,Business,Business Administration,5,3,2
1998,Business,Business Administration,441,303,138
1998,Business,Business Administration,45,26,19
1999,Business,Business Administration,382,150,232
1999,Business,Business Administration,101,43,58
1999,Business,Business Administration,30,20,10
1999,Business,Business Administration,330,213,117
1999,Business,Business Administration,35,27,8
1999,Business,Business Administration,5,4,1
1999,Business,Business Administration,346,230,116
1999,Business,Business Administration,45,29,16
2000,Business,Business Administration,391,150,241
2000,Business,Business Administration,92,40,52
2000,Business,Business Administration,4,3,1
2000,Business,Business Administration,34,21,13
2000,Business,Business Administration,331,211,120
2000,Business,Business Administration,48,32,16
2000,Business,Business Administration,368,236,132
2000,Business,Business Administration,50,32,18
2001,Business,Business Administration,421,162,259
2001,Business,Business Administration,94,34,60
2001,Business,Business Administration,3,2,1
2001,Business,Business Administration,37,28,9
2001,Business,Business Administration,340,228,112
2001,Business,Business Administration,49,40,9
2001,Business,Business Administration,387,262,125
2001,Business,Business Administration,52,31,21
2002,Business,Business Administration,403,153,250
2002,Business,Business Administration,99,42,57
2002,Business,Business Administration,35,30,5
2002,Business,Business Administration,264,179,85
2002,Business,Business Administration,59,44,15
2002,Business,Business Administration,341,245,96
2002,Business,Business Administration,53,26,27
1997,Business,Business Administration,2,1,1
1998,Business,Business Administration,20,12,8
1999,Business,Business Administration,19,11,8
1992,Business,Business Administration,6,3,3
1993,Business,Business Administration,51,29,22
1994,Business,Business Administration,56,25,31
1995,Business,Business Administration,57,31,26
1996,Business,Business Administration,60,32,28
1997,Business,Business Administration,67,38,29
1998,Business,Business Administration,90,51,39
1999,Business,Business Administration,62,40,22
2000,Business,Business Administration,59,37,22
2001,Business,Business Administration,43,22,21
2002,Business,Business Administration,33,19,14
1980,Business,Business Administration,1005,529,476
1984,Business,Business Administration,628,267,361
1985,Business,Business Administration,608,251,357
1986,Business,Business Administration,548,248,300
1987,Business,Business Administration,540,270,270
1988,Business,Business Administration,579,299,280
1989,Business,Business Administration,567,307,260
1990,Business,Business Administration,649,351,298
1991,Business,Business Administration,619,335,284
1992,Business,Business Administration,23,8,15
1993,Business,Business Administration,21,11,10
2018,Business,Business Administration,55,20,33
2018,Business,Business Administration,40,21,19
2017,Business,Business Administration,52,23,29
2017,Business,Business Administration,40,21,19
2016,Business,Business Administration,48,21,27
2016,Business,Business Administration,40,20,20
2015,Business,Business Administration,4,2,2
2015,Business,Business Administration,40,24,16
2015,Business,Business Administration,45,12,33
2014,Business,Business Administration,42,24,18
2014,Business,Business Administration,46,15,31
2013,Business,Business Administration,19,5,14
2013,Business,Business Administration,50,28,22
2012,Business,Business Administration,1,1,0
2012,Business,Business Administration,46,24,22
2011,Business,Business Administration,1,1,0
2011,Business,Business Administration,43,24,19
2010,Business,Business Administration,4,2,2
2010,Business,Business Administration,2,0,2
2010,Business,Business Administration,2,2,0
2010,Business,Business Administration,50,27,23
2009,Business,Business Administration,8,2,6
2009,Business,Business Administration,6,5,1
2009,Business,Business Administration,1,1,0
2009,Business,Business Administration,1,1,0
2009,Business,Business Administration,13,11,2
2009,Business,Business Administration,35,16,19
2009,Business,Business Administration,46,24,22
2008,Business,Business Administration,13,10,3
2008,Business,Business Administration,1,1,0
2008,Business,Business Administration,4,3,1
2008,Business,Business Administration,39,27,12
2008,Business,Business Administration,36,13,23
2008,Business,Business Administration,113,38,75
2008,Business,Business Administration,48,28,20
2007,Business,Business Administration,1,1,0
2007,Business,Business Administration,12,9,3
2007,Business,Business Administration,14,11,3
2007,Business,Business Administration,52,35,17
2007,Business,Business Administration,38,30,8
2007,Business,Business Administration,67,28,39
2007,Business,Business Administration,226,75,150
2007,Business,Business Administration,47,37,10
2007,Business,Business Administration,52,28,24
2006,Business,Business Administration,1,1,0
2006,Business,Business Administration,2,1,1
2006,Business,Business Administration,20,17,3
2006,Business,Business Administration,76,32,44
2006,Business,Business Administration,28,21,7
2006,Business,Business Administration,91,70,21
2006,Business,Business Administration,59,42,17
2006,Business,Business Administration,369,125,244
2006,Business,Business Administration,52,44,8
2006,Business,Business Administration,56,29,27
2005,Business,Business Administration,2,1,1
2005,Business,Business Administration,3,2,1
2005,Business,Business Administration,98,40,58
2005,Business,Business Administration,28,21,7
2005,Business,Business Administration,62,40,22
2005,Business,Business Administration,114,86,28
2005,Business,Business Administration,14,10,4
2005,Business,Business Administration,84,59,25
2005,Business,Business Administration,41,25,16
2005,Business,Business Administration,53,27,26
2005,Business,Business Administration,453,179,274
2004,Business,Business Administration,403,161,242
2004,Business,Business Administration,91,33,58
2004,Business,Business Administration,4,3,1
2004,Business,Business Administration,43,25,18
2004,Business,Business Administration,29,21,8
2004,Business,Business Administration,113,77,36
2004,Business,Business Administration,82,55,27
2004,Business,Business Administration,1,1,0
2004,Business,Business Administration,43,32,11
2004,Business,Business Administration,51,26,25
2018,Business,Business Administration (MBA),92,61,31
2018,Business,Business Administration (MBA),113,71,42
2018,Business,Business Administration (MBA),1,1,0
2018,Business,Business Administration (MBA),1,1,0
2018,Business,Business Administration (MBA),1592,1059,528
2018,Business,Business Administration (MBA),210,163,46
2018,Business,Business Administration (MBA),8,3,5
2017,Business,Business Administration (MBA),96,63,33
2017,Business,Business Administration (MBA),93,54,39
2017,Business,Business Administration (MBA),32,24,8
2017,Business,Business Administration (MBA),787,540,246
2017,Business,Business Administration (MBA),150,102,48
2016,Business,Business Administration (MBA),122,87,35
2016,Business,Business Administration (MBA),96,57,39
2016,Business,Business Administration (MBA),36,24,12
2015,Business,Business Administration (MBA),1,1,0
2015,Business,Business Administration (MBA),104,71,33
2015,Business,Business Administration (MBA),154,112,42
2015,Business,Business Administration (MBA),29,19,10
2014,Business,Business Administration (MBA),98,70,28
2014,Business,Business Administration (MBA),156,116,40
2014,Business,Business Administration (MBA),57,39,18
2013,Business,Business Administration (MBA),1,1,0
2013,Business,Business Administration (MBA),190,131,59
2013,Business,Business Administration (MBA),105,68,37
2013,Business,Business Administration (MBA),56,44,12
2012,Business,Business Administration (MBA),104,73,31
2012,Business,Business Administration (MBA),237,165,72
2012,Business,Business Administration (MBA),60,44,16
2011,Business,Business Administration (MBA),80,60,20
2011,Business,Business Administration (MBA),217,157,60
2011,Business,Business Administration (MBA),47,34,13
2010,Business,Business Administration (MBA),14,12,2
2010,Business,Business Administration (MBA),45,31,14
2010,Business,Business Administration (MBA),200,130,70
2010,Business,Business Administration (MBA),3,1,1
2010,Business,Business Administration (MBA),57,47,10
2009,Business,Business Administration (MBA),62,40,22
2009,Business,Business Administration (MBA),198,127,71
2009,Business,Business Administration (MBA),85,68,14
2008,Business,Business Administration (MBA),67,49,18
2008,Business,Business Administration (MBA),198,140,58
2008,Business,Business Administration (MBA),90,69,18
2007,Business,Business Administration (MBA),64,49,15
2007,Business,Business Administration (MBA),206,143,63
2007,Business,Business Administration (MBA),101,83,18
2006,Business,Business Administration (MBA),17,14,3
2006,Business,Business Administration (MBA),20,14,6
2006,Business,Business Administration (MBA),1,1,0
2006,Business,Business Administration (MBA),197,128,69
2006,Business,Business Administration (MBA),94,77,16
2005,Business,Business Administration (MBA),182,127,55
2005,Business,Business Administration (MBA),56,44,12
2004,Business,Business Administration (MBA),252,181,71
2004,Business,Business Administration (MBA),53,44,9
1994,Education,BUSINESS ED ACT,2,1,1
2018,Business,Business Process Management,3,1,2
2018,Business,Business Process Management,14,11,3
2017,Business,Business Process Management,11,6,5
2017,Business,Business Process Management,24,11,13
2016,Business,Business Process Management,17,8,9
2016,Business,Business Process Management,23,12,11
2015,Business,Business Process Management,14,8,6
2015,Business,Business Process Management,22,12,10
2014,Business,Business Process Management,13,6,7
2014,Business,Business Process Management,16,8,8
2013,Business,Business Process Management,23,12,11
2013,Business,Business Process Management,12,7,5
2012,Business,Business Process Management,23,16,7
2012,Business,Business Process Management,9,3,6
2011,Business,Business Process Management,20,14,6
2011,Business,Business Process Management,11,4,7
2010,Business,Business Process Management,5,2,3
2010,Business,Business Process Management,18,10,8
2009,Business,Business Process Management,3,2,1
2009,Business,Business Process Management,15,8,7
2008,Business,Business Process Management,6,3,3
2007,Business,Business Process Management,2,1,1
1997,Business,CBA NON-DEGREE,12,6,6
1998,Business,CBA NON-DEGREE,25,13,12
1999,Business,CBA NON-DEGREE,34,18,16
2000,Business,CBA NON-DEGREE,45,23,22
2001,Business,CBA NON-DEGREE,54,32,22
2002,Business,CBA NON-DEGREE,53,31,22
1998,LAS,CELL & STR BIOL,11,7,4
1999,LAS,CELL & STR BIOL,51,31,20
2000,LAS,CELL & STR BIOL,46,30,16
2001,LAS,CELL & STR BIOL,51,30,21
2002,LAS,CELL & STR BIOL,59,33,26
2003,LAS,CELL & STR BIOL,68,38,30
2018,LAS,Cell and Developmental Biology,31,13,18
2017,LAS,Cell and Developmental Biology,31,15,16
2016,LAS,Cell and Developmental Biology,38,16,22
2015,LAS,Cell and Developmental Biology,45,20,25
2014,LAS,Cell and Developmental Biology,1,0,1
2014,LAS,Cell and Developmental Biology,51,24,27
2013,LAS,Cell and Developmental Biology,43,18,25
2012,LAS,Cell and Developmental Biology,39,19,20
2011,LAS,Cell and Developmental Biology,38,18,20
2010,LAS,Cell and Developmental Biology,42,23,19
2009,LAS,Cell and Developmental Biology,44,20,24
2008,LAS,Cell and Developmental Biology,1,0,1
2008,LAS,Cell and Developmental Biology,45,19,26
2011,LAS,Cell and Structural Biology,2,2,0
2010,LAS,Cell and Structural Biology,3,3,0
2009,LAS,Cell and Structural Biology,3,3,0
2008,LAS,Cell and Structural Biology,4,3,1
2007,LAS,Cell and Structural Biology,65,30,35
2006,LAS,Cell and Structural Biology,1,1,0
2006,LAS,Cell and Structural Biology,67,34,33
2005,LAS,Cell and Structural Biology,74,35,39
2004,LAS,Cell and Structural Biology,12,7,5
2004,LAS,Cell and Structural Biology,78,43,35
1980,Engineering,CER ENGR,117,95,22
1980,Engineering,CER ENGR,35,28,7
1981,Engineering,CER ENGR,97,78,19
1981,Engineering,CER ENGR,3,2,1
1981,Engineering,CER ENGR,35,26,9
1982,Engineering,CER ENGR,81,59,22
1982,Engineering,CER ENGR,5,4,1
1982,Engineering,CER ENGR,31,24,7
1983,Engineering,CER ENGR,111,83,28
1983,Engineering,CER ENGR,4,3,1
1983,Engineering,CER ENGR,40,35,5
1984,Engineering,CER ENGR,113,80,33
1984,Engineering,CER ENGR,2,1,1
1984,Engineering,CER ENGR,41,36,5
1985,Engineering,CER ENGR,132,98,34
1985,Engineering,CER ENGR,2,1,1
1985,Engineering,CER ENGR,2,1,1
1985,Engineering,CER ENGR,44,37,7
1986,Engineering,CER ENGR,153,116,37
1986,Engineering,CER ENGR,4,3,1
1986,Engineering,CER ENGR,6,4,2
1986,Engineering,CER ENGR,41,33,8
1987,Engineering,CER ENGR,168,128,40
1987,Engineering,CER ENGR,5,3,2
1987,Engineering,CER ENGR,9,6,3
1987,Engineering,CER ENGR,64,57,7
1988,Engineering,CER ENGR,172,132,40
1988,Engineering,CER ENGR,6,4,2
1988,Engineering,CER ENGR,7,6,1
1988,Engineering,CER ENGR,63,57,6
1989,Engineering,CER ENGR,178,147,31
1989,Engineering,CER ENGR,49,46,3
1990,Engineering,CER ENGR,150,119,31
1990,Engineering,CER ENGR,52,50,2
1991,Engineering,CER ENGR,133,106,27
1991,Engineering,CER ENGR,10,9,1
1991,Engineering,CER ENGR,43,41,2
1992,Engineering,CER ENGR,131,107,24
1992,Engineering,CER ENGR,7,6,1
1992,Engineering,CER ENGR,52,48,4
1993,Engineering,CER ENGR,134,114,20
1993,Engineering,CER ENGR,5,4,1
1993,Engineering,CER ENGR,44,39,5
1994,Engineering,CER ENGR,120,107,13
1994,Engineering,CER ENGR,7,5,2
1994,Engineering,CER ENGR,8,4,4
1995,Engineering,CER ENGR,81,67,14
1995,Engineering,CER ENGR,6,5,1
1995,Engineering,CER ENGR,2,1,1
1996,Engineering,CER ENGR,38,28,10
1997,Engineering,CER ENGR,25,20,5
1981,Engineering,CERAMICS,3,2,1
1990,Engineering,CERAMICS,4,3,1
1991,Engineering,CERAMICS,9,5,4
1992,Engineering,CERAMICS,13,9,4
1993,Engineering,CERAMICS,12,10,2
1995,Engineering,CERAMICS,2,1,1
1996,Engineering,CERAMICS,2,1,1
1997,ACES,CFTM-CNSMR&TXTL,67,4,63
1998,ACES,CFTM-CNSMR&TXTL,77,9,68
1999,ACES,CFTM-CNSMR&TXTL,84,13,71
2000,ACES,CFTM-CNSMR&TXTL,110,12,98
2001,ACES,CFTM-CNSMR&TXTL,116,17,99
2002,ACES,CFTM-CNSMR&TXTL,53,2,51
2003,ACES,CFTM-CNSMR&TXTL,15,1,14
1997,ACES,CFTM-MKT&PRICE,12,10,2
1998,ACES,CFTM-MKT&PRICE,24,19,5
1999,ACES,CFTM-MKT&PRICE,30,24,6
2000,ACES,CFTM-MKT&PRICE,27,17,10
2001,ACES,CFTM-MKT&PRICE,13,6,7
2002,ACES,CFTM-MKT&PRICE,3,2,1
2003,LAS,CHEM E NUS,5,4,1
2018,LAS,Chemical Engineering,643,430,211
2018,LAS,Chemical Engineering,10,9,1
2018,LAS,Chemical Engineering,1,0,1
2018,LAS,Chemical Engineering,95,60,35
2018,LAS,Chemical Engineering,7,3,4
2017,LAS,Chemical Engineering,675,457,218
2017,LAS,Chemical Engineering,13,10,3
2017,LAS,Chemical Engineering,2,0,2
2017,LAS,Chemical Engineering,92,58,34
2017,LAS,Chemical Engineering,3,1,2
2016,LAS,Chemical Engineering,685,492,193
2016,LAS,Chemical Engineering,15,14,1
2016,LAS,Chemical Engineering,2,0,2
2016,LAS,Chemical Engineering,92,57,35
2015,LAS,Chemical Engineering,3,1,2
2015,LAS,Chemical Engineering,18,15,3
2015,LAS,Chemical Engineering,84,50,34
2015,LAS,Chemical Engineering,663,483,180
2014,LAS,Chemical Engineering,2,1,1
2014,LAS,Chemical Engineering,14,10,4
2014,LAS,Chemical Engineering,82,54,28
2014,LAS,Chemical Engineering,692,497,195
2013,LAS,Chemical Engineering,8,2,6
2013,LAS,Chemical Engineering,3,1,2
2013,LAS,Chemical Engineering,97,66,31
2013,LAS,Chemical Engineering,660,465,195
2012,LAS,Chemical Engineering,10,5,5
2012,LAS,Chemical Engineering,2,0,2
2012,LAS,Chemical Engineering,1,0,1
2012,LAS,Chemical Engineering,1,0,1
2012,LAS,Chemical Engineering,103,70,33
2012,LAS,Chemical Engineering,539,368,171
2011,LAS,Chemical Engineering,13,10,3
2011,LAS,Chemical Engineering,3,0,3
2011,LAS,Chemical Engineering,1,0,1
2011,LAS,Chemical Engineering,1,0,1
2011,LAS,Chemical Engineering,99,66,33
2011,LAS,Chemical Engineering,527,355,172
2010,LAS,Chemical Engineering,11,8,3
2010,LAS,Chemical Engineering,4,1,3
2010,LAS,Chemical Engineering,1,0,1
2010,LAS,Chemical Engineering,102,65,37
2010,LAS,Chemical Engineering,503,343,159
2009,LAS,Chemical Engineering,17,14,3
2009,LAS,Chemical Engineering,7,4,3
2009,LAS,Chemical Engineering,438,292,145
2009,LAS,Chemical Engineering,112,68,44
2008,LAS,Chemical Engineering,14,9,5
2008,LAS,Chemical Engineering,5,3,2
2008,LAS,Chemical Engineering,401,268,133
2008,LAS,Chemical Engineering,103,66,37
2007,LAS,Chemical Engineering,4,4,0
2007,LAS,Chemical Engineering,3,1,2
2007,LAS,Chemical Engineering,5,3,2
2007,LAS,Chemical Engineering,368,246,122
2007,LAS,Chemical Engineering,92,59,33
2006,LAS,Chemical Engineering,2,1,1
2006,LAS,Chemical Engineering,5,2,3
2006,LAS,Chemical Engineering,328,208,119
2006,LAS,Chemical Engineering,90,61,29
2005,LAS,Chemical Engineering,6,3,3
2005,LAS,Chemical Engineering,5,3,2
2005,LAS,Chemical Engineering,294,187,106
2005,LAS,Chemical Engineering,89,62,27
2004,LAS,Chemical Engineering,304,199,105
2004,LAS,Chemical Engineering,11,7,4
2004,LAS,Chemical Engineering,4,3,1
2004,LAS,Chemical Engineering,98,73,25
2018,LAS,Chemical Physics,3,2,1
2017,LAS,Chemical Physics,6,5,1
2016,LAS,Chemical Physics,6,5,1
2015,LAS,Chemical Physics,7,6,1
2014,LAS,Chemical Physics,8,7,1
2013,LAS,Chemical Physics,9,8,1
2012,LAS,Chemical Physics,9,7,2
2011,LAS,Chemical Physics,10,8,2
2010,LAS,Chemical Physics,9,8,1
2009,LAS,Chemical Physics,11,9,2
2008,LAS,Chemical Physics,13,10,3
2007,LAS,Chemical Physics,12,9,3
2006,LAS,Chemical Physics,11,9,2
2005,LAS,Chemical Physics,10,8,2
2004,LAS,Chemical Physics,6,5,1
1980,LAS,Chemical Physics,6,5,1
1981,LAS,Chemical Physics,7,5,2
1982,LAS,Chemical Physics,6,4,2
1983,LAS,Chemical Physics,8,5,3
1984,LAS,Chemical Physics,6,5,1
1987,LAS,Chemical Physics,3,2,1
1988,LAS,Chemical Physics,5,3,2
1989,LAS,Chemical Physics,5,3,2
1990,LAS,Chemical Physics,9,7,2
1991,LAS,Chemical Physics,9,8,1
1992,LAS,Chemical Physics,11,10,1
1993,LAS,Chemical Physics,14,13,1
1994,LAS,Chemical Physics,11,10,1
1995,LAS,Chemical Physics,12,11,1
1996,LAS,Chemical Physics,9,8,1
1997,LAS,Chemical Physics,7,6,1
1998,LAS,Chemical Physics,4,3,1
1999,LAS,Chemical Physics,4,2,2
2000,LAS,Chemical Physics,6,3,3
2001,LAS,Chemical Physics,4,2,2
2002,LAS,Chemical Physics,4,2,2
2003,LAS,Chemical Physics,6,4,2
2018,LAS,Chemistry,233,136,97
2018,LAS,Chemistry,1,1,0
2018,LAS,Chemistry,264,126,138
2018,LAS,Chemistry,16,9,7
2018,LAS,Chemistry,3,3,0
2018,LAS,Chemistry,5,3,2
2018,LAS,Chemistry,276,174,102
2017,LAS,Chemistry,230,139,91
2017,LAS,Chemistry,2,2,0
2017,LAS,Chemistry,278,141,137
2017,LAS,Chemistry,20,11,9
2017,LAS,Chemistry,3,2,1
2017,LAS,Chemistry,4,3,1
2017,LAS,Chemistry,282,179,103
2016,LAS,Chemistry,239,152,87
2016,LAS,Chemistry,1,1,0
2016,LAS,Chemistry,273,151,122
2016,LAS,Chemistry,21,8,13
2016,LAS,Chemistry,7,2,5
2016,LAS,Chemistry,3,3,0
2016,LAS,Chemistry,292,184,108
2015,LAS,Chemistry,3,2,1
2015,LAS,Chemistry,8,3,5
2015,LAS,Chemistry,1,1,0
2015,LAS,Chemistry,27,16,11
2015,LAS,Chemistry,304,175,129
2015,LAS,Chemistry,232,141,91
2015,LAS,Chemistry,306,189,117
2014,LAS,Chemistry,7,5,2
2014,LAS,Chemistry,9,4,5
2014,LAS,Chemistry,22,14,8
2014,LAS,Chemistry,158,101,57
2014,LAS,Chemistry,344,207,137
2014,LAS,Chemistry,305,183,122
2013,LAS,Chemistry,3,2,1
2013,LAS,Chemistry,1,1,0
2013,LAS,Chemistry,2,1,1
2013,LAS,Chemistry,15,4,11
2013,LAS,Chemistry,2,2,0
2013,LAS,Chemistry,9,5,4
2013,LAS,Chemistry,302,183,119
2013,LAS,Chemistry,141,91,50
2013,LAS,Chemistry,325,206,119
2012,LAS,Chemistry,2,1,1
2012,LAS,Chemistry,16,10,6
2012,LAS,Chemistry,9,4,5
2012,LAS,Chemistry,2,2,0
2012,LAS,Chemistry,149,102,47
2012,LAS,Chemistry,283,185,98
2012,LAS,Chemistry,342,192,150
2011,LAS,Chemistry,4,2,2
2011,LAS,Chemistry,12,4,8
2011,LAS,Chemistry,14,8,6
2011,LAS,Chemistry,270,177,93
2011,LAS,Chemistry,158,101,57
2011,LAS,Chemistry,295,167,128
2010,LAS,Chemistry,1,1,0
2010,LAS,Chemistry,9,3,6
2010,LAS,Chemistry,16,11,5
2010,LAS,Chemistry,157,99,57
2010,LAS,Chemistry,267,185,82
2010,LAS,Chemistry,280,151,129
2009,LAS,Chemistry,16,11,5
2009,LAS,Chemistry,9,4,5
2009,LAS,Chemistry,3,2,1
2009,LAS,Chemistry,146,89,56
2009,LAS,Chemistry,278,148,130
2009,LAS,Chemistry,291,204,87
2008,LAS,Chemistry,13,9,4
2008,LAS,Chemistry,3,3,0
2008,LAS,Chemistry,1,0,1
2008,LAS,Chemistry,142,91,51
2008,LAS,Chemistry,289,141,148
2008,LAS,Chemistry,275,193,82
2007,LAS,Chemistry,11,5,6
2007,LAS,Chemistry,1,0,1
2007,LAS,Chemistry,2,2,0
2007,LAS,Chemistry,4,4,0
2007,LAS,Chemistry,126,74,52
2007,LAS,Chemistry,321,157,164
2007,LAS,Chemistry,276,198,78
2006,LAS,Chemistry,1,0,1
2006,LAS,Chemistry,8,4,4
2006,LAS,Chemistry,2,2,0
2006,LAS,Chemistry,4,4,0
2006,LAS,Chemistry,146,92,54
2006,LAS,Chemistry,383,193,189
2006,LAS,Chemistry,302,217,85
2005,LAS,Chemistry,1,0,1
2005,LAS,Chemistry,10,4,6
2005,LAS,Chemistry,4,1,3
2005,LAS,Chemistry,7,1,6
2005,LAS,Chemistry,141,79,62
2005,LAS,Chemistry,312,167,145
2005,LAS,Chemistry,285,197,88
2004,LAS,Chemistry,1,1,0
2004,LAS,Chemistry,125,69,56
2004,LAS,Chemistry,274,127,147
2004,LAS,Chemistry,2,1,1
2004,LAS,Chemistry,292,189,103
2018,Engineering,Civil Engineering,671,487,184
2018,Engineering,Civil Engineering,303,219,84
2018,Engineering,Civil Engineering,46,33,13
2018,Engineering,Civil Engineering,3,2,1
2018,Engineering,Civil Engineering,179,142,37
2018,Engineering,Civil Engineering,23,18,5
2017,Engineering,Civil Engineering,716,515,201
2017,Engineering,Civil Engineering,371,252,119
2017,Engineering,Civil Engineering,36,29,7
2017,Engineering,Civil Engineering,1,1,0
2017,Engineering,Civil Engineering,176,145,31
2017,Engineering,Civil Engineering,19,15,4
2016,Engineering,Civil Engineering,757,553,204
2016,Engineering,Civil Engineering,375,262,113
2016,Engineering,Civil Engineering,1,1,0
2016,Engineering,Civil Engineering,186,149,37
2016,Engineering,Civil Engineering,10,7,3
2015,Engineering,Civil Engineering,2,2,0
2015,Engineering,Civil Engineering,190,148,42
2015,Engineering,Civil Engineering,730,536,194
2015,Engineering,Civil Engineering,397,290,107
2014,Engineering,Civil Engineering,188,146,42
2014,Engineering,Civil Engineering,712,536,176
2014,Engineering,Civil Engineering,394,290,104
2013,Engineering,Civil Engineering,351,261,90
2013,Engineering,Civil Engineering,161,126,35
2013,Engineering,Civil Engineering,775,583,192
2012,Engineering,Civil Engineering,151,119,32
2012,Engineering,Civil Engineering,299,225,74
2012,Engineering,Civil Engineering,791,597,194
2011,Engineering,Civil Engineering,137,111,26
2011,Engineering,Civil Engineering,254,193,60
2011,Engineering,Civil Engineering,787,589,198
2010,Engineering,Civil Engineering,137,115,22
2010,Engineering,Civil Engineering,229,180,48
2010,Engineering,Civil Engineering,803,580,221
2009,Engineering,Civil Engineering,186,143,43
2009,Engineering,Civil Engineering,764,552,210
2009,Engineering,Civil Engineering,140,121,19
2008,Engineering,Civil Engineering,2,0,2
2008,Engineering,Civil Engineering,134,100,34
2008,Engineering,Civil Engineering,667,505,161
2008,Engineering,Civil Engineering,152,130,22
2007,Engineering,Civil Engineering,1,0,1
2007,Engineering,Civil Engineering,544,415,128
2007,Engineering,Civil Engineering,132,104,28
2007,Engineering,Civil Engineering,153,135,18
2006,Engineering,Civil Engineering,523,412,111
2006,Engineering,Civil Engineering,124,99,25
2006,Engineering,Civil Engineering,146,127,19
2005,Engineering,Civil Engineering,1,0,1
2005,Engineering,Civil Engineering,493,393,100
2005,Engineering,Civil Engineering,151,120,31
2005,Engineering,Civil Engineering,150,128,22
2004,Engineering,Civil Engineering,450,347,103
2004,Engineering,Civil Engineering,147,111,36
2004,Engineering,Civil Engineering,2,2,0
2004,Engineering,Civil Engineering,158,139,19
2018,LAS,Classical Philology,10,7,3
2017,LAS,Classical Philology,11,8,3
2016,LAS,Classical Philology,10,7,3
2015,LAS,Classical Philology,10,7,3
2014,LAS,Classical Philology,8,4,4
2013,LAS,Classical Philology,8,6,2
2012,LAS,Classical Philology,9,5,4
2011,LAS,Classical Philology,8,5,3
2010,LAS,Classical Philology,7,4,3
2009,LAS,Classical Philology,9,5,4
2008,LAS,Classical Philology,5,3,2
2007,LAS,Classical Philology,5,2,3
2006,LAS,Classical Philology,4,2,2
2005,LAS,Classical Philology,7,5,2
2004,LAS,Classical Philology,7,5,2
1980,LAS,Classical Philology,9,7,2
1981,LAS,Classical Philology,11,9,2
1982,LAS,Classical Philology,11,9,2
1983,LAS,Classical Philology,10,8,2
1984,LAS,Classical Philology,11,8,3
1985,LAS,Classical Philology,8,6,2
1986,LAS,Classical Philology,7,5,2
1987,LAS,Classical Philology,9,7,2
1988,LAS,Classical Philology,7,5,2
1989,LAS,Classical Philology,8,7,1
1990,LAS,Classical Philology,8,6,2
1991,LAS,Classical Philology,5,3,2
1992,LAS,Classical Philology,9,5,4
1993,LAS,Classical Philology,8,5,3
1994,LAS,Classical Philology,12,8,4
1995,LAS,Classical Philology,13,9,4
1996,LAS,Classical Philology,12,9,3
1997,LAS,Classical Philology,8,7,1
1998,LAS,Classical Philology,4,3,1
1999,LAS,Classical Philology,6,4,2
2000,LAS,Classical Philology,4,3,1
2001,LAS,Classical Philology,5,3,2
2002,LAS,Classical Philology,6,4,2
2003,LAS,Classical Philology,8,6,2
2018,LAS,Classics,12,6,6
2018,LAS,Classics,1,0,1
2018,LAS,Classics,3,1,2
2018,LAS,Classics,1,0,1
2017,LAS,Classics,5,3,2
2017,LAS,Classics,1,0,1
2017,LAS,Classics,2,0,2
2017,LAS,Classics,1,1,0
2017,LAS,Classics,2,0,2
2017,LAS,Classics,1,0,1
2017,LAS,Classics,1,0,1
2016,LAS,Classics,7,5,2
2016,LAS,Classics,1,1,0
2016,LAS,Classics,2,0,2
2016,LAS,Classics,1,0,1
2015,LAS,Classics,1,1,0
2015,LAS,Classics,1,1,0
2015,LAS,Classics,1,1,0
2015,LAS,Classics,1,0,1
2015,LAS,Classics,1,0,1
2015,LAS,Classics,8,3,5
2015,LAS,Classics,3,3,0
2014,LAS,Classics,1,1,0
2014,LAS,Classics,1,1,0
2014,LAS,Classics,13,9,4
2014,LAS,Classics,7,6,1
2013,LAS,Classics,12,9,3
2013,LAS,Classics,1,1,0
2013,LAS,Classics,1,1,0
2013,LAS,Classics,2,1,1
2013,LAS,Classics,1,0,1
2013,LAS,Classics,8,5,3
2012,LAS,Classics,9,6,3
2012,LAS,Classics,1,1,0
2012,LAS,Classics,4,1,3
2012,LAS,Classics,3,1,2
2012,LAS,Classics,1,0,1
2012,LAS,Classics,7,4,3
2011,LAS,Classics,6,4,2
2011,LAS,Classics,2,1,1
2011,LAS,Classics,1,1,0
2011,LAS,Classics,4,1,3
2011,LAS,Classics,3,2,1
2011,LAS,Classics,10,6,4
2010,LAS,Classics,11,5,6
2010,LAS,Classics,1,0,1
2010,LAS,Classics,2,2,0
2010,LAS,Classics,7,5,2
2010,LAS,Classics,1,1,0
2010,LAS,Classics,8,4,4
2010,LAS,Classics,8,5,3
2009,LAS,Classics,9,4,5
2009,LAS,Classics,1,1,0
2009,LAS,Classics,1,1,0
2009,LAS,Classics,13,5,8
2009,LAS,Classics,7,5,2
2009,LAS,Classics,5,2,3
2008,LAS,Classics,12,4,8
2008,LAS,Classics,1,0,1
2008,LAS,Classics,6,3,3
2008,LAS,Classics,11,5,6
2008,LAS,Classics,7,2,5
2007,LAS,Classics,14,8,6
2007,LAS,Classics,10,5,5
2007,LAS,Classics,3,1,2
2007,LAS,Classics,10,5,5
2006,LAS,Classics,3,2,1
2006,LAS,Classics,2,1,1
2006,LAS,Classics,7,4,3
2006,LAS,Classics,7,3,4
2006,LAS,Classics,19,12,7
2005,LAS,Classics,2,1,1
2005,LAS,Classics,4,1,3
2005,LAS,Classics,5,2,3
2005,LAS,Classics,15,8,7
2005,LAS,Classics,8,4,4
2004,LAS,Classics,24,10,14
2004,LAS,Classics,1,0,1
2004,LAS,Classics,3,2,1
2004,LAS,Classics,1,0,1
2004,LAS,Classics,6,2,4
2001,ACES,"CMDTY,FD,TXTL M",15,3,12
2002,ACES,"CMDTY,FD,TXTL M",79,9,70
2018,LAS,Communication,670,256,414
2018,LAS,Communication,27,9,18
2018,LAS,Communication,6,2,4
2018,LAS,Communication,29,13,16
2017,LAS,Communication,654,233,421
2017,LAS,Communication,21,4,17
2017,LAS,Communication,12,4,8
2017,LAS,Communication,29,15,14
2016,LAS,Communication,676,253,423
2016,LAS,Communication,26,6,20
2016,LAS,Communication,15,6,9
2016,LAS,Communication,33,14,19
2015,LAS,Communication,29,8,21
2015,LAS,Communication,17,6,11
2015,LAS,Communication,37,11,26
2015,LAS,Communication,703,288,415
2014,LAS,Communication,36,8,28
2014,LAS,Communication,20,4,16
2014,LAS,Communication,40,14,26
2014,LAS,Communication,735,333,401
2013,LAS,Communication,19,6,13
2013,LAS,Communication,19,4,15
2013,LAS,Communication,37,13,24
2013,LAS,Communication,742,320,421
2012,LAS,Communication,18,5,13
2012,LAS,Communication,21,7,14
2012,LAS,Communication,34,9,25
2012,LAS,Communication,800,345,454
2011,LAS,Communication,13,6,7
2011,LAS,Communication,29,7,22
2011,LAS,Communication,31,8,23
2011,LAS,Communication,793,333,459
2010,LAS,Communication,14,3,11
2010,LAS,Communication,25,5,20
2010,LAS,Communication,28,10,18
2010,LAS,Communication,777,308,469
2009,LAS,Communication,2,0,2
2009,LAS,Communication,13,4,9
2009,LAS,Communication,24,8,16
2009,LAS,Communication,469,193,276
2017,Media,Communications,2,0,2
2016,Media,Communications,1,0,1
2015,Media,Communications,6,2,4
2015,Media,Communications,1,1,0
2014,Media,Communications,9,2,7
2013,Media,Communications,21,6,15
2012,Media,Communications,29,12,17
2011,Media,Communications,38,16,22
2010,Media,Communications,49,22,27
2009,Media,Communications,50,23,27
2008,Media,Communications,49,23,26
2007,Media,Communications,56,24,32
2006,Media,Communications,60,30,30
2005,Media,Communications,51,22,29
2004,Media,Communications,50,24,26
2018,Media,Communications and Media,47,14,33
2017,Media,Communications and Media,47,15,32
2016,Media,Communications and Media,45,14,31
2015,Media,Communications and Media,40,13,27
2014,Media,Communications and Media,32,11,21
2013,Media,Communications and Media,27,10,17
2012,Media,Communications and Media,21,8,13
2011,Media,Communications and Media,1,0,1
2011,Media,Communications and Media,14,5,9
2010,Media,Communications and Media,7,3,4
2018,Applied Health Sciences,Community Health,198,65,133
2018,Applied Health Sciences,Community Health,105,18,87
2018,Applied Health Sciences,Community Health,261,64,197
2018,Applied Health Sciences,Community Health,44,5,39
2018,Applied Health Sciences,Community Health,22,3,19
2018,Applied Health Sciences,Community Health,26,5,21
2017,Applied Health Sciences,Community Health,153,38,115
2017,Applied Health Sciences,Community Health,117,22,95
2017,Applied Health Sciences,Community Health,265,61,204
2017,Applied Health Sciences,Community Health,44,4,40
2017,Applied Health Sciences,Community Health,12,2,10
2017,Applied Health Sciences,Community Health,23,4,19
2016,Applied Health Sciences,Community Health,107,31,76
2016,Applied Health Sciences,Community Health,120,21,99
2016,Applied Health Sciences,Community Health,280,65,215
2016,Applied Health Sciences,Community Health,64,14,50
2016,Applied Health Sciences,Community Health,2,0,2
2016,Applied Health Sciences,Community Health,24,2,22
2015,Applied Health Sciences,Community Health,2,0,2
2015,Applied Health Sciences,Community Health,68,21,47
2015,Applied Health Sciences,Community Health,140,21,119
2015,Applied Health Sciences,Community Health,71,25,46
2015,Applied Health Sciences,Community Health,302,74,228
2015,Applied Health Sciences,Community Health,32,6,26
2014,Applied Health Sciences,Community Health,2,0,2
2014,Applied Health Sciences,Community Health,142,18,124
2014,Applied Health Sciences,Community Health,80,32,48
2014,Applied Health Sciences,Community Health,94,30,64
2014,Applied Health Sciences,Community Health,294,78,216
2014,Applied Health Sciences,Community Health,32,8,24
2013,Applied Health Sciences,Community Health,4,0,4
2013,Applied Health Sciences,Community Health,34,10,24
2013,Applied Health Sciences,Community Health,98,43,55
2013,Applied Health Sciences,Community Health,111,32,79
2013,Applied Health Sciences,Community Health,157,23,134
2013,Applied Health Sciences,Community Health,267,83,184
2012,Applied Health Sciences,Community Health,1,1,0
2012,Applied Health Sciences,Community Health,7,1,6
2012,Applied Health Sciences,Community Health,97,29,68
2012,Applied Health Sciences,Community Health,29,9,20
2012,Applied Health Sciences,Community Health,107,45,62
2012,Applied Health Sciences,Community Health,170,28,142
2012,Applied Health Sciences,Community Health,263,74,189
2011,Applied Health Sciences,Community Health,1,1,0
2011,Applied Health Sciences,Community Health,11,4,7
2011,Applied Health Sciences,Community Health,28,7,21
2011,Applied Health Sciences,Community Health,92,27,65
2011,Applied Health Sciences,Community Health,88,26,62
2011,Applied Health Sciences,Community Health,142,24,117
2011,Applied Health Sciences,Community Health,243,66,176
2010,Applied Health Sciences,Community Health,2,1,1
2010,Applied Health Sciences,Community Health,10,4,6
2010,Applied Health Sciences,Community Health,20,6,14
2010,Applied Health Sciences,Community Health,72,14,58
2010,Applied Health Sciences,Community Health,115,27,88
2010,Applied Health Sciences,Community Health,136,16,120
2010,Applied Health Sciences,Community Health,196,58,137
2009,Applied Health Sciences,Community Health,8,4,4
2009,Applied Health Sciences,Community Health,5,1,4
2009,Applied Health Sciences,Community Health,123,16,107
2009,Applied Health Sciences,Community Health,68,9,59
2009,Applied Health Sciences,Community Health,233,52,180
2009,Applied Health Sciences,Community Health,20,5,15
2009,Applied Health Sciences,Community Health,131,36,95
2008,Applied Health Sciences,Community Health,10,0,10
2008,Applied Health Sciences,Community Health,13,8,5
2008,Applied Health Sciences,Community Health,51,4,47
2008,Applied Health Sciences,Community Health,132,19,113
2008,Applied Health Sciences,Community Health,218,56,162
2008,Applied Health Sciences,Community Health,17,5,12
2008,Applied Health Sciences,Community Health,171,39,132
2007,Applied Health Sciences,Community Health,13,1,12
2007,Applied Health Sciences,Community Health,12,5,7
2007,Applied Health Sciences,Community Health,44,7,37
2007,Applied Health Sciences,Community Health,143,38,105
2007,Applied Health Sciences,Community Health,117,14,103
2007,Applied Health Sciences,Community Health,187,53,134
2007,Applied Health Sciences,Community Health,15,4,11
2007,Applied Health Sciences,Community Health,1,1,0
2006,Applied Health Sciences,Community Health,2,1,1
2006,Applied Health Sciences,Community Health,27,3,24
2006,Applied Health Sciences,Community Health,7,1,6
2006,Applied Health Sciences,Community Health,3,0,3
2006,Applied Health Sciences,Community Health,108,12,96
2006,Applied Health Sciences,Community Health,134,33,101
2006,Applied Health Sciences,Community Health,193,48,145
2006,Applied Health Sciences,Community Health,1,0,1
2006,Applied Health Sciences,Community Health,7,0,7
2006,Applied Health Sciences,Community Health,2,1,1
2006,Applied Health Sciences,Community Health,4,1,3
2006,Applied Health Sciences,Community Health,9,5,4
2005,Applied Health Sciences,Community Health,2,0,2
2005,Applied Health Sciences,Community Health,4,1,3
2005,Applied Health Sciences,Community Health,32,5,27
2005,Applied Health Sciences,Community Health,11,1,10
2005,Applied Health Sciences,Community Health,87,9,78
2005,Applied Health Sciences,Community Health,6,1,5
2005,Applied Health Sciences,Community Health,102,33,69
2005,Applied Health Sciences,Community Health,9,5,4
2005,Applied Health Sciences,Community Health,194,47,147
2004,Applied Health Sciences,Community Health,129,28,101
2004,Applied Health Sciences,Community Health,57,4,53
2004,Applied Health Sciences,Community Health,138,32,106
2004,Applied Health Sciences,Community Health,23,4,19
2004,Applied Health Sciences,Community Health,13,3,10
2004,Applied Health Sciences,Community Health,4,0,4
2004,Applied Health Sciences,Community Health,11,6,5
2018,LAS,Comparative Literature,8,2,6
2018,LAS,Comparative Literature,1,0,1
2018,LAS,Comparative Literature,1,1,0
2018,LAS,Comparative Literature,7,2,5
2018,LAS,Comparative Literature,1,0,1
2018,LAS,Comparative Literature,11,2,9
2017,LAS,Comparative Literature,4,2,2
2017,LAS,Comparative Literature,2,0,2
2017,LAS,Comparative Literature,7,1,6
2017,LAS,Comparative Literature,10,4,6
2016,LAS,Comparative Literature,3,1,2
2016,LAS,Comparative Literature,4,1,3
2016,LAS,Comparative Literature,8,0,8
2016,LAS,Comparative Literature,9,4,5
2015,LAS,Comparative Literature,2,0,2
2015,LAS,Comparative Literature,3,2,1
2015,LAS,Comparative Literature,8,4,4
2015,LAS,Comparative Literature,9,0,9
2014,LAS,Comparative Literature,1,1,0
2014,LAS,Comparative Literature,1,0,1
2014,LAS,Comparative Literature,2,1,1
2014,LAS,Comparative Literature,10,3,7
2014,LAS,Comparative Literature,14,3,11
2013,LAS,Comparative Literature,2,1,1
2013,LAS,Comparative Literature,1,1,0
2013,LAS,Comparative Literature,1,0,1
2013,LAS,Comparative Literature,13,4,9
2013,LAS,Comparative Literature,8,4,4
2012,LAS,Comparative Literature,5,4,1
2012,LAS,Comparative Literature,1,1,0
2012,LAS,Comparative Literature,2,1,1
2012,LAS,Comparative Literature,8,2,6
2012,LAS,Comparative Literature,11,4,7
2011,LAS,Comparative Literature,2,2,0
2011,LAS,Comparative Literature,4,1,2
2011,LAS,Comparative Literature,8,4,4
2011,LAS,Comparative Literature,12,2,10
2011,LAS,Comparative Literature,6,1,4
2010,LAS,Comparative Literature,10,4,6
2010,LAS,Comparative Literature,1,0,1
2010,LAS,Comparative Literature,4,3,1
2010,LAS,Comparative Literature,16,3,13
2010,LAS,Comparative Literature,8,3,4
2009,LAS,Comparative Literature,9,3,6
2009,LAS,Comparative Literature,10,5,4
2009,LAS,Comparative Literature,1,0,1
2009,LAS,Comparative Literature,1,0,1
2009,LAS,Comparative Literature,6,2,4
2009,LAS,Comparative Literature,17,6,11
2008,LAS,Comparative Literature,9,2,7
2008,LAS,Comparative Literature,7,3,4
2008,LAS,Comparative Literature,7,1,6
2008,LAS,Comparative Literature,21,7,14
2007,LAS,Comparative Literature,1,0,1
2007,LAS,Comparative Literature,13,4,9
2007,LAS,Comparative Literature,5,1,4
2007,LAS,Comparative Literature,11,1,10
2007,LAS,Comparative Literature,26,7,19
2006,LAS,Comparative Literature,15,5,10
2006,LAS,Comparative Literature,3,0,3
2006,LAS,Comparative Literature,19,5,14
2006,LAS,Comparative Literature,25,6,19
2005,LAS,Comparative Literature,8,2,6
2005,LAS,Comparative Literature,6,1,5
2005,LAS,Comparative Literature,18,2,16
2005,LAS,Comparative Literature,32,10,22
2004,LAS,Comparative Literature,13,5,8
2004,LAS,Comparative Literature,15,6,9
2004,LAS,Comparative Literature,20,3,17
2018,Engineering,Computer Engineering,1184,1032,152
2017,Engineering,Computer Engineering,1270,1114,156
2016,Engineering,Computer Engineering,1195,1063,132
2015,Engineering,Computer Engineering,1062,952,109
2014,Engineering,Computer Engineering,905,813,92
2013,Engineering,Computer Engineering,791,721,70
2012,Engineering,Computer Engineering,697,635,62
2011,Engineering,Computer Engineering,608,563,45
2010,Engineering,Computer Engineering,524,480,43
2009,Engineering,Computer Engineering,469,423,45
2008,Engineering,Computer Engineering,446,398,46
2007,Engineering,Computer Engineering,434,397,35
2006,Engineering,Computer Engineering,477,439,36
2005,Engineering,Computer Engineering,563,520,42
2004,Engineering,Computer Engineering,636,588,48
2018,LAS,Computer Sci & Anthropology,36,26,10
2017,LAS,Computer Sci & Anthropology,26,17,9
2016,LAS,Computer Sci & Anthropology,15,11,4
2016,LAS,Computer Sci & Anthropology,1,0,1
2015,LAS,Computer Sci & Anthropology,1,0,1
2015,LAS,Computer Sci & Anthropology,10,8,2
2014,LAS,Computer Sci & Anthropology,1,0,1
2014,LAS,Computer Sci & Anthropology,8,6,2
2018,LAS,Computer Sci & Astronomy,39,32,7
2017,LAS,Computer Sci & Astronomy,30,24,6
2017,LAS,Computer Sci & Astronomy,2,2,0
2016,LAS,Computer Sci & Astronomy,32,26,6
2015,LAS,Computer Sci & Astronomy,18,14,4
2014,LAS,Computer Sci & Astronomy,8,6,2
2018,LAS,Computer Sci & Chemistry,40,32,8
2018,LAS,Computer Sci & Chemistry,1,0,1
2017,LAS,Computer Sci & Chemistry,46,37,9
2017,LAS,Computer Sci & Chemistry,1,0,1
2016,LAS,Computer Sci & Chemistry,31,22,9
2016,LAS,Computer Sci & Chemistry,1,0,1
2015,LAS,Computer Sci & Chemistry,27,18,9
2014,LAS,Computer Sci & Chemistry,15,10,5
2013,LAS,Computer Sci & Chemistry,1,0,1
2018,LAS,Computer Sci & Linguistics,73,50,23
2018,LAS,Computer Sci & Linguistics,3,1,2
2017,LAS,Computer Sci & Linguistics,68,48,20
2017,LAS,Computer Sci & Linguistics,1,0,1
2016,LAS,Computer Sci & Linguistics,52,35,17
2016,LAS,Computer Sci & Linguistics,1,1,0
2015,LAS,Computer Sci & Linguistics,1,1,0
2015,LAS,Computer Sci & Linguistics,26,18,8
2014,LAS,Computer Sci & Linguistics,8,5,3
2018,Engineering,Computer Science,1012,709,302
2018,Engineering,Computer Science,42,33,9
2018,Engineering,Computer Science,116,87,29
2018,Engineering,Computer Science,33,30,3
2018,Engineering,Computer Science,586,478,107
2018,Engineering,Computer Science,43,37,6
2018,Engineering,Computer Science,124,92,32
2018,Engineering,Computer Science,8,7,1
2018,Engineering,Computer Science,9,7,2
2018,Engineering,Computer Science,345,277,68
2017,Engineering,Computer Science,1045,750,295
2017,Engineering,Computer Science,18,14,4
2017,Engineering,Computer Science,59,49,10
2017,Engineering,Computer Science,81,60,21
2017,Engineering,Computer Science,51,45,6
2017,Engineering,Computer Science,286,240,46
2017,Engineering,Computer Science,39,30,9
2017,Engineering,Computer Science,122,94,28
2017,Engineering,Computer Science,17,14,3
2017,Engineering,Computer Science,1,1,0
2017,Engineering,Computer Science,6,4,2
2017,Engineering,Computer Science,323,256,67
2016,Engineering,Computer Science,1070,800,270
2016,Engineering,Computer Science,23,18,5
2016,Engineering,Computer Science,12,8,4
2016,Engineering,Computer Science,64,45,19
2016,Engineering,Computer Science,1,1,0
2016,Engineering,Computer Science,125,103,22
2016,Engineering,Computer Science,14,14,0
2016,Engineering,Computer Science,98,76,22
2016,Engineering,Computer Science,21,16,5
2016,Engineering,Computer Science,319,246,73
2016,Engineering,Computer Science,1,1,0
2015,Engineering,Computer Science,13,11,2
2015,Engineering,Computer Science,26,23,3
2015,Engineering,Computer Science,20,20,0
2015,Engineering,Computer Science,27,22,5
2015,Engineering,Computer Science,85,69,16
2015,Engineering,Computer Science,99,75,24
2015,Engineering,Computer Science,310,242,68
2015,Engineering,Computer Science,1060,848,212
2014,Engineering,Computer Science,1,1,0
2014,Engineering,Computer Science,1,1,0
2014,Engineering,Computer Science,9,8,1
2014,Engineering,Computer Science,78,60,18
2014,Engineering,Computer Science,89,65,24
2014,Engineering,Computer Science,304,235,69
2014,Engineering,Computer Science,1114,935,179
2013,Engineering,Computer Science,1,1,0
2013,Engineering,Computer Science,45,32,13
2013,Engineering,Computer Science,35,27,8
2013,Engineering,Computer Science,75,55,20
2013,Engineering,Computer Science,12,11,1
2013,Engineering,Computer Science,307,242,65
2013,Engineering,Computer Science,1039,924,115
2012,Engineering,Computer Science,2,2,0
2012,Engineering,Computer Science,63,44,19
2012,Engineering,Computer Science,62,52,10
2012,Engineering,Computer Science,1,1,0
2012,Engineering,Computer Science,9,8,1
2012,Engineering,Computer Science,304,252,52
2012,Engineering,Computer Science,945,866,79
2011,Engineering,Computer Science,14,13,1
2011,Engineering,Computer Science,25,20,5
2011,Engineering,Computer Science,39,33,6
2011,Engineering,Computer Science,4,3,1
2011,Engineering,Computer Science,306,258,48
2011,Engineering,Computer Science,841,763,78
2010,Engineering,Computer Science,3,2,1
2010,Engineering,Computer Science,8,8,0
2010,Engineering,Computer Science,1,1,0
2010,Engineering,Computer Science,33,24,9
2010,Engineering,Computer Science,7,6,1
2010,Engineering,Computer Science,325,278,47
2010,Engineering,Computer Science,792,714,78
2009,Engineering,Computer Science,4,4,0
2009,Engineering,Computer Science,2,2,0
2009,Engineering,Computer Science,5,5,0
2009,Engineering,Computer Science,33,21,12
2009,Engineering,Computer Science,676,610,66
2009,Engineering,Computer Science,315,272,43
2008,Engineering,Computer Science,4,3,1
2008,Engineering,Computer Science,3,3,0
2008,Engineering,Computer Science,14,11,3
2008,Engineering,Computer Science,27,17,10
2008,Engineering,Computer Science,625,558,66
2008,Engineering,Computer Science,307,266,41
2007,Engineering,Computer Science,1,1,0
2007,Engineering,Computer Science,5,5,0
2007,Engineering,Computer Science,4,3,1
2007,Engineering,Computer Science,14,11,3
2007,Engineering,Computer Science,20,17,3
2007,Engineering,Computer Science,592,526,64
2007,Engineering,Computer Science,320,271,49
2006,Engineering,Computer Science,2,2,0
2006,Engineering,Computer Science,1,0,1
2006,Engineering,Computer Science,2,2,0
2006,Engineering,Computer Science,6,6,0
2006,Engineering,Computer Science,6,5,1
2006,Engineering,Computer Science,32,27,5
2006,Engineering,Computer Science,620,559,59
2006,Engineering,Computer Science,318,266,52
2005,Engineering,Computer Science,6,6,0
2005,Engineering,Computer Science,3,3,0
2005,Engineering,Computer Science,10,9,1
2005,Engineering,Computer Science,11,8,3
2005,Engineering,Computer Science,54,51,3
2005,Engineering,Computer Science,644,583,59
2005,Engineering,Computer Science,336,283,53
2004,Engineering,Computer Science,710,633,76
2004,Engineering,Computer Science,10,10,0
2004,Engineering,Computer Science,21,18,3
2004,Engineering,Computer Science,78,73,4
2004,Engineering,Computer Science,17,17,0
2004,Engineering,Computer Science,3,2,1
2004,Engineering,Computer Science,353,300,53
2018,LAS,Computer Science & Economics,2,2,0
2018,LAS,Computer Science & Economics,1,1,0
2018,Fine and Applied Arts,Computer Science and Music,1,1,0
2018,ACES,Computer Science&Crop Sciences,4,4,0
1982,ACES,CONSM ECON,2,1,1
1983,ACES,CONSM ECON,14,2,12
1984,ACES,CONSM ECON,21,4,17
1985,ACES,CONSM ECON,30,8,22
1986,ACES,CONSM ECON,36,13,23
1987,ACES,CONSM ECON,40,12,28
1988,ACES,CONSM ECON,44,11,33
1989,ACES,CONSM ECON,46,13,33
1990,ACES,CONSM ECON,57,21,36
1991,ACES,CONSM ECON,76,31,45
1992,ACES,CONSM ECON,47,20,27
1993,ACES,CONSM ECON,46,12,34
1994,ACES,CONSM ECON,38,14,24
1995,ACES,CONSM ECON,33,18,15
1996,ACES,CONSM ECON,35,20,15
1997,ACES,CONSM ECON,6,2,4
2007,ACES,Consumer and Textile Marketing,9,1,8
2006,ACES,Consumer and Textile Marketing,31,1,30
2005,ACES,Consumer and Textile Marketing,54,2,52
2004,ACES,Consumer and Textile Marketing,98,3,95
2004,ACES,Consumer and Textile Marketing,1,0,1
1980,ACES,CORE CURR,158,124,34
1981,ACES,CORE CURR,155,112,43
1982,ACES,CORE CURR,115,76,39
1983,ACES,CORE CURR,103,73,30
1984,ACES,CORE CURR,115,80,35
1985,ACES,CORE CURR,82,55,27
1986,ACES,CORE CURR,71,54,17
1987,ACES,CORE CURR,70,47,23
1988,ACES,CORE CURR,52,34,18
1989,ACES,CORE CURR,57,36,21
1990,ACES,CORE CURR,59,38,21
1991,ACES,CORE CURR,64,45,19
1992,ACES,CORE CURR,67,50,17
1993,ACES,CORE CURR,54,37,17
1994,ACES,CORE CURR,43,34,9
1995,ACES,CORE CURR,45,29,16
1996,ACES,CORE CURR,32,18,14
1997,ACES,CORE CURR,9,6,3
1980,Fine and Applied Arts,Crafts,20,5,15
1981,Fine and Applied Arts,Crafts,19,7,12
1982,Fine and Applied Arts,Crafts,25,5,20
1983,Fine and Applied Arts,Crafts,22,6,16
1984,Fine and Applied Arts,Crafts,16,8,8
1985,Fine and Applied Arts,Crafts,15,4,11
1986,Fine and Applied Arts,Crafts,18,8,10
1987,Fine and Applied Arts,Crafts,19,6,13
1988,Fine and Applied Arts,Crafts,23,7,16
1989,Fine and Applied Arts,Crafts,22,6,16
1990,Fine and Applied Arts,Crafts,23,7,16
1991,Fine and Applied Arts,Crafts,16,5,11
1992,Fine and Applied Arts,Crafts,26,8,18
1993,Fine and Applied Arts,Crafts,31,7,24
1994,Fine and Applied Arts,Crafts,37,9,28
1995,Fine and Applied Arts,Crafts,41,10,31
1996,Fine and Applied Arts,Crafts,39,12,27
1997,Fine and Applied Arts,Crafts,39,15,24
1998,Fine and Applied Arts,Crafts,36,15,21
1999,Fine and Applied Arts,Crafts,33,8,25
2000,Fine and Applied Arts,Crafts,35,11,24
2001,Fine and Applied Arts,Crafts,31,7,24
2002,Fine and Applied Arts,Crafts,29,7,22
2003,Fine and Applied Arts,Crafts,32,9,23
2018,Fine and Applied Arts,Crafts,1,0,1
2018,Fine and Applied Arts,Crafts,3,0,3
2017,Fine and Applied Arts,Crafts,1,0,1
2017,Fine and Applied Arts,Crafts,5,0,5
2016,Fine and Applied Arts,Crafts,10,1,9
2015,Fine and Applied Arts,Crafts,2,0,2
2015,Fine and Applied Arts,Crafts,14,1,12
2014,Fine and Applied Arts,Crafts,2,0,2
2014,Fine and Applied Arts,Crafts,14,0,14
2013,Fine and Applied Arts,Crafts,3,0,3
2013,Fine and Applied Arts,Crafts,15,1,14
2012,Fine and Applied Arts,Crafts,3,1,2
2012,Fine and Applied Arts,Crafts,11,2,9
2011,Fine and Applied Arts,Crafts,4,2,2
2011,Fine and Applied Arts,Crafts,8,0,8
2010,Fine and Applied Arts,Crafts,4,1,3
2010,Fine and Applied Arts,Crafts,10,0,10
2009,Fine and Applied Arts,Crafts,5,2,3
2009,Fine and Applied Arts,Crafts,9,1,8
2008,Fine and Applied Arts,Crafts,11,2,9
2008,Fine and Applied Arts,Crafts,9,3,6
2007,Fine and Applied Arts,Crafts,9,2,7
2007,Fine and Applied Arts,Crafts,1,0,1
2007,Fine and Applied Arts,Crafts,12,3,9
2006,Fine and Applied Arts,Crafts,4,1,3
2006,Fine and Applied Arts,Crafts,2,1,1
2006,Fine and Applied Arts,Crafts,17,4,13
2005,Fine and Applied Arts,Crafts,4,2,2
2005,Fine and Applied Arts,Crafts,9,2,7
2005,Fine and Applied Arts,Crafts,9,3,6
2004,Fine and Applied Arts,Crafts,1,0,1
2004,Fine and Applied Arts,Crafts,9,2,7
2004,Fine and Applied Arts,Crafts,8,5,3
2004,Fine and Applied Arts,Crafts,12,2,10
2005,Fine and Applied Arts,Creative Writing,3,0,3
2004,Fine and Applied Arts,Creative Writing,3,0,3
2018,LAS,Creative Writing,75,26,49
2018,LAS,Creative Writing,5,1,4
2018,LAS,Creative Writing,18,11,7
2017,LAS,Creative Writing,80,30,50
2017,LAS,Creative Writing,7,3,4
2017,LAS,Creative Writing,16,9,7
2016,LAS,Creative Writing,84,30,54
2016,LAS,Creative Writing,8,1,7
2016,LAS,Creative Writing,16,7,9
2015,LAS,Creative Writing,5,0,5
2015,LAS,Creative Writing,69,24,45
2015,LAS,Creative Writing,17,9,8
2014,LAS,Creative Writing,6,1,5
2014,LAS,Creative Writing,44,16,28
2014,LAS,Creative Writing,16,7,9
2013,LAS,Creative Writing,18,6,12
2013,LAS,Creative Writing,23,12,11
2012,LAS,Creative Writing,16,4,12
2011,LAS,Creative Writing,16,7,9
2010,LAS,Creative Writing,16,7,9
2009,LAS,Creative Writing,19,10,9
2008,LAS,Creative Writing,20,9,11
2007,LAS,Creative Writing,20,10,10
2006,LAS,Creative Writing,20,8,12
2005,LAS,Creative Writing,18,8,10
2004,LAS,Creative Writing,24,14,10
2002,LAS,Creative Writing,14,9,5
2003,LAS,Creative Writing,23,12,11
1998,ACES,Crop Sciences,4,2,2
1999,ACES,Crop Sciences,5,1,4
2000,ACES,Crop Sciences,3,1,2
1998,ACES,Crop Sciences,4,3,1
1999,ACES,Crop Sciences,4,2,2
2000,ACES,Crop Sciences,2,1,1
2002,ACES,Crop Sciences,5,2,3
2003,ACES,Crop Sciences,5,2,3
1998,ACES,Crop Sciences,21,20,1
1999,ACES,Crop Sciences,40,38,2
2000,ACES,Crop Sciences,36,33,3
2001,ACES,Crop Sciences,29,24,5
2002,ACES,Crop Sciences,25,23,2
2003,ACES,Crop Sciences,27,26,1
1997,ACES,Crop Sciences,22,20,2
1998,ACES,Crop Sciences,31,25,6
1999,ACES,Crop Sciences,33,28,5
2000,ACES,Crop Sciences,27,23,4
2001,ACES,Crop Sciences,21,20,1
2002,ACES,Crop Sciences,20,19,1
2003,ACES,Crop Sciences,11,10,1
1997,ACES,Crop Sciences,10,4,6
1998,ACES,Crop Sciences,17,8,9
1999,ACES,Crop Sciences,24,15,9
2000,ACES,Crop Sciences,22,10,12
2001,ACES,Crop Sciences,31,13,18
2002,ACES,Crop Sciences,26,9,17
2003,ACES,Crop Sciences,33,13,20
1997,ACES,Crop Sciences,6,1,5
1998,ACES,Crop Sciences,8,2,6
1999,ACES,Crop Sciences,14,7,7
2000,ACES,Crop Sciences,13,5,8
2001,ACES,Crop Sciences,7,4,3
2002,ACES,Crop Sciences,4,2,2
2003,ACES,Crop Sciences,3,2,1
1998,ACES,Crop Sciences,14,8,6
1999,ACES,Crop Sciences,33,20,13
2000,ACES,Crop Sciences,52,35,17
2001,ACES,Crop Sciences,61,32,29
2002,ACES,Crop Sciences,72,37,35
2003,ACES,Crop Sciences,64,39,25
2018,ACES,Crop Sciences,9,2,7
2018,ACES,Crop Sciences,2,1,1
2018,ACES,Crop Sciences,20,13,7
2018,ACES,Crop Sciences,33,22,11
2018,ACES,Crop Sciences,50,28,22
2018,ACES,Crop Sciences,6,3,3
2018,ACES,Crop Sciences,12,4,8
2018,ACES,Crop Sciences,33,22,11
2018,ACES,Crop Sciences,22,13,9
2018,ACES,Crop Sciences,51,28,23
2017,ACES,Crop Sciences,6,1,5
2017,ACES,Crop Sciences,4,3,1
2017,ACES,Crop Sciences,19,15,4
2017,ACES,Crop Sciences,42,29,13
2017,ACES,Crop Sciences,53,26,27
2017,ACES,Crop Sciences,2,1,1
2017,ACES,Crop Sciences,1,0,1
2017,ACES,Crop Sciences,15,3,12
2017,ACES,Crop Sciences,37,24,13
2017,ACES,Crop Sciences,23,14,9
2017,ACES,Crop Sciences,47,30,17
2016,ACES,Crop Sciences,5,3,2
2016,ACES,Crop Sciences,5,3,2
2016,ACES,Crop Sciences,22,16,6
2016,ACES,Crop Sciences,49,33,16
2016,ACES,Crop Sciences,48,25,23
2016,ACES,Crop Sciences,3,1,2
2016,ACES,Crop Sciences,1,0,1
2016,ACES,Crop Sciences,11,3,8
2016,ACES,Crop Sciences,46,22,24
2016,ACES,Crop Sciences,5,5,0
2016,ACES,Crop Sciences,60,40,20
2015,ACES,Crop Sciences,5,3,2
2015,ACES,Crop Sciences,2,1,1
2015,ACES,Crop Sciences,5,4,1
2015,ACES,Crop Sciences,4,1,3
2015,ACES,Crop Sciences,39,28,11
2015,ACES,Crop Sciences,52,35,17
2015,ACES,Crop Sciences,53,28,25
2015,ACES,Crop Sciences,42,15,27
2015,ACES,Crop Sciences,62,37,25
2014,ACES,Crop Sciences,2,1,1
2014,ACES,Crop Sciences,4,2,2
2014,ACES,Crop Sciences,1,1,0
2014,ACES,Crop Sciences,3,2,1
2014,ACES,Crop Sciences,5,2,3
2014,ACES,Crop Sciences,27,19,8
2014,ACES,Crop Sciences,57,42,15
2014,ACES,Crop Sciences,56,31,25
2014,ACES,Crop Sciences,39,11,28
2014,ACES,Crop Sciences,68,49,19
2013,ACES,Crop Sciences,7,3,4
2013,ACES,Crop Sciences,2,1,1
2013,ACES,Crop Sciences,1,1,0
2013,ACES,Crop Sciences,61,42,19
2013,ACES,Crop Sciences,24,19,5
2013,ACES,Crop Sciences,45,35,10
2013,ACES,Crop Sciences,6,5,1
2013,ACES,Crop Sciences,45,21,24
2013,ACES,Crop Sciences,55,36,19
2012,ACES,Crop Sciences,1,0,1
2012,ACES,Crop Sciences,29,23,6
2012,ACES,Crop Sciences,43,38,5
2012,ACES,Crop Sciences,1,1,0
2012,ACES,Crop Sciences,4,3,1
2012,ACES,Crop Sciences,64,47,17
2012,ACES,Crop Sciences,6,4,2
2012,ACES,Crop Sciences,47,26,21
2012,ACES,Crop Sciences,33,22,11
2011,ACES,Crop Sciences,3,2,1
2011,ACES,Crop Sciences,22,19,3
2011,ACES,Crop Sciences,38,30,8
2011,ACES,Crop Sciences,1,0,1
2011,ACES,Crop Sciences,1,1,0
2011,ACES,Crop Sciences,56,40,16
2011,ACES,Crop Sciences,26,17,9
2011,ACES,Crop Sciences,3,3,0
2011,ACES,Crop Sciences,48,35,13
2010,ACES,Crop Sciences,2,2,0
2010,ACES,Crop Sciences,25,18,7
2010,ACES,Crop Sciences,42,34,8
2010,ACES,Crop Sciences,1,0,1
2010,ACES,Crop Sciences,45,33,12
2010,ACES,Crop Sciences,1,1,0
2010,ACES,Crop Sciences,48,36,12
2010,ACES,Crop Sciences,25,13,12
2010,ACES,Crop Sciences,5,2,3
2009,ACES,Crop Sciences,3,2,1
2009,ACES,Crop Sciences,23,16,7
2009,ACES,Crop Sciences,42,34,8
2009,ACES,Crop Sciences,9,5,4
2009,ACES,Crop Sciences,1,1,0
2009,ACES,Crop Sciences,21,12,9
2009,ACES,Crop Sciences,33,23,10
2009,ACES,Crop Sciences,31,22,9
2008,ACES,Crop Sciences,2,2,0
2008,ACES,Crop Sciences,17,13,4
2008,ACES,Crop Sciences,23,22,1
2008,ACES,Crop Sciences,25,13,12
2008,ACES,Crop Sciences,9,4,5
2008,ACES,Crop Sciences,37,21,16
2008,ACES,Crop Sciences,29,17,12
2007,ACES,Crop Sciences,2,1,1
2007,ACES,Crop Sciences,1,1,0
2007,ACES,Crop Sciences,18,16,2
2007,ACES,Crop Sciences,23,21,2
2007,ACES,Crop Sciences,11,6,5
2007,ACES,Crop Sciences,30,16,14
2007,ACES,Crop Sciences,32,18,14
2007,ACES,Crop Sciences,29,17,12
2006,ACES,Crop Sciences,2,1,1
2006,ACES,Crop Sciences,2,2,0
2006,ACES,Crop Sciences,17,15,2
2006,ACES,Crop Sciences,26,23,3
2006,ACES,Crop Sciences,20,11,9
2006,ACES,Crop Sciences,32,20,12
2006,ACES,Crop Sciences,31,16,15
2006,ACES,Crop Sciences,23,16,7
2005,ACES,Crop Sciences,2,2,0
2005,ACES,Crop Sciences,12,4,8
2005,ACES,Crop Sciences,24,20,4
2005,ACES,Crop Sciences,29,28,1
2005,ACES,Crop Sciences,27,15,11
2005,ACES,Crop Sciences,31,11,20
2005,ACES,Crop Sciences,24,17,7
2004,ACES,Crop Sciences,2,2,0
2004,ACES,Crop Sciences,17,14,3
2004,ACES,Crop Sciences,27,27,0
2004,ACES,Crop Sciences,34,17,16
2004,ACES,Crop Sciences,4,2,2
2004,ACES,Crop Sciences,36,22,14
2004,ACES,Crop Sciences,2,2,0
2004,ACES,Crop Sciences,32,19,13
2003,ACES,CTM-CNSMR&TXTL,119,10,109
1983,Applied Health Sciences,CUR INST 2,21,3,18
1984,Applied Health Sciences,CUR INST 2,25,6,19
1985,Applied Health Sciences,CUR INST 2,23,8,15
1986,Applied Health Sciences,CUR INST 2,19,11,8
1987,Applied Health Sciences,CUR INST 2,22,12,10
1988,Applied Health Sciences,CUR INST 2,13,4,9
1989,Applied Health Sciences,CUR INST 2,3,1,2
1990,Applied Health Sciences,CUR INST 2,2,1,1
1983,Applied Health Sciences,CUR INST#1,3,2,1
1984,Applied Health Sciences,CUR INST#1,5,4,1
1985,Applied Health Sciences,CUR INST#1,8,6,2
1986,Applied Health Sciences,CUR INST#1,6,5,1
1987,Applied Health Sciences,CUR INST#1,10,7,3
1989,Applied Health Sciences,CUR INST#1,6,5,1
1990,Applied Health Sciences,CUR INST#1,8,7,1
1992,Applied Health Sciences,CUR INST#1,9,7,2
1993,Applied Health Sciences,CUR INST#1,7,6,1
1983,Applied Health Sciences,CUR INST#3,9,3,6
1984,Applied Health Sciences,CUR INST#3,10,6,4
1985,Applied Health Sciences,CUR INST#3,10,9,1
1986,Applied Health Sciences,CUR INST#3,12,10,2
1987,Applied Health Sciences,CUR INST#3,13,10,3
1988,Applied Health Sciences,CUR INST#3,15,8,7
1989,Applied Health Sciences,CUR INST#3,14,6,8
1990,Applied Health Sciences,CUR INST#3,8,5,3
1991,Applied Health Sciences,CUR INST#3,8,6,2
1992,Applied Health Sciences,CUR INST#3,4,3,1
1993,Applied Health Sciences,CUR INST#3,5,3,2
1994,Applied Health Sciences,CUR INST#3,5,3,2
2018,Business,Curric Unassigned,1021,575,445
2017,Business,Curric Unassigned,934,504,428
2016,Business,Curric Unassigned,1015,581,434
2015,Business,Curric Unassigned,1026,564,462
2014,Business,Curric Unassigned,975,534,441
2013,Business,Curric Unassigned,983,542,441
2012,Business,Curric Unassigned,924,534,390
2011,Business,Curric Unassigned,1032,583,449
2010,Business,Curric Unassigned,1020,583,437
2009,Business,Curric Unassigned,1038,574,464
2008,Business,Curric Unassigned,1139,652,487
2007,Business,Curric Unassigned,1006,578,428
2006,Business,Curric Unassigned,754,453,300
2005,Business,Curric Unassigned,363,220,142
2004,Business,Curric Unassigned,385,241,144
2018,Education,Curriculum and Instruction,1,0,1
2018,Education,Curriculum and Instruction,2,0,2
2018,Education,Curriculum and Instruction,20,2,18
2018,Education,Curriculum and Instruction,5,0,5
2018,Education,Curriculum and Instruction,4,1,3
2018,Education,Curriculum and Instruction,46,14,32
2018,Education,Curriculum and Instruction,1,0,1
2017,Education,Curriculum and Instruction,1,0,1
2017,Education,Curriculum and Instruction,2,0,2
2017,Education,Curriculum and Instruction,31,5,26
2017,Education,Curriculum and Instruction,4,1,3
2017,Education,Curriculum and Instruction,1,0,1
2017,Education,Curriculum and Instruction,1,0,1
2017,Education,Curriculum and Instruction,50,15,35
2017,Education,Curriculum and Instruction,1,1,0
2016,Education,Curriculum and Instruction,1,0,1
2016,Education,Curriculum and Instruction,5,2,3
2016,Education,Curriculum and Instruction,27,3,24
2016,Education,Curriculum and Instruction,3,1,2
2016,Education,Curriculum and Instruction,2,1,1
2016,Education,Curriculum and Instruction,2,0,2
2016,Education,Curriculum and Instruction,1,0,1
2016,Education,Curriculum and Instruction,60,18,42
2015,Education,Curriculum and Instruction,2,0,2
2015,Education,Curriculum and Instruction,1,0,1
2015,Education,Curriculum and Instruction,3,1,2
2015,Education,Curriculum and Instruction,3,1,2
2015,Education,Curriculum and Instruction,36,3,33
2015,Education,Curriculum and Instruction,71,22,49
2014,Education,Curriculum and Instruction,1,0,1
2014,Education,Curriculum and Instruction,1,0,1
2014,Education,Curriculum and Instruction,1,0,1
2014,Education,Curriculum and Instruction,4,1,3
2014,Education,Curriculum and Instruction,7,1,6
2014,Education,Curriculum and Instruction,33,2,31
2014,Education,Curriculum and Instruction,65,18,47
2013,Education,Curriculum and Instruction,5,1,4
2013,Education,Curriculum and Instruction,4,1,3
2013,Education,Curriculum and Instruction,1,0,1
2013,Education,Curriculum and Instruction,6,2,4
2013,Education,Curriculum and Instruction,34,4,30
2013,Education,Curriculum and Instruction,63,20,43
2012,Education,Curriculum and Instruction,7,1,6
2012,Education,Curriculum and Instruction,4,1,3
2012,Education,Curriculum and Instruction,1,0,1
2012,Education,Curriculum and Instruction,5,2,3
2012,Education,Curriculum and Instruction,56,15,41
2012,Education,Curriculum and Instruction,40,5,35
2011,Education,Curriculum and Instruction,1,0,1
2011,Education,Curriculum and Instruction,1,0,1
2011,Education,Curriculum and Instruction,5,0,5
2011,Education,Curriculum and Instruction,48,10,38
2011,Education,Curriculum and Instruction,11,4,7
2011,Education,Curriculum and Instruction,55,8,47
2010,Education,Curriculum and Instruction,2,1,1
2010,Education,Curriculum and Instruction,40,11,29
2010,Education,Curriculum and Instruction,2,0,2
2010,Education,Curriculum and Instruction,36,5,31
2010,Education,Curriculum and Instruction,9,3,6
2009,Education,Curriculum and Instruction,4,0,4
2009,Education,Curriculum and Instruction,2,1,1
2009,Education,Curriculum and Instruction,8,1,7
2009,Education,Curriculum and Instruction,31,5,26
2009,Education,Curriculum and Instruction,25,4,21
2008,Education,Curriculum and Instruction,4,0,4
2008,Education,Curriculum and Instruction,2,0,2
2008,Education,Curriculum and Instruction,15,2,13
2008,Education,Curriculum and Instruction,1,0,1
2008,Education,Curriculum and Instruction,14,3,11
1980,ACES,DAIRY SCI,21,16,5
1980,ACES,DAIRY SCI,30,23,7
1981,ACES,DAIRY SCI,33,19,14
1981,ACES,DAIRY SCI,34,27,7
1982,ACES,DAIRY SCI,30,15,15
1982,ACES,DAIRY SCI,37,29,8
1983,ACES,DAIRY SCI,33,22,11
1983,ACES,DAIRY SCI,34,24,10
1984,ACES,DAIRY SCI,34,23,11
1984,ACES,DAIRY SCI,33,26,7
1985,ACES,DAIRY SCI,20,15,5
1985,ACES,DAIRY SCI,33,24,9
1986,ACES,DAIRY SCI,16,11,5
1986,ACES,DAIRY SCI,30,22,8
1987,ACES,DAIRY SCI,12,9,3
1987,ACES,DAIRY SCI,20,14,6
1988,ACES,DAIRY SCI,6,5,1
1988,ACES,DAIRY SCI,11,9,2
1989,ACES,DAIRY SCI,4,3,1
1989,ACES,DAIRY SCI,5,4,1
1990,ACES,DAIRY SCI,3,2,1
1980,Fine and Applied Arts,Dance,30,3,27
1980,Fine and Applied Arts,Dance,11,2,9
1981,Fine and Applied Arts,Dance,27,4,23
1981,Fine and Applied Arts,Dance,14,1,13
1982,Fine and Applied Arts,Dance,34,2,32
1983,Fine and Applied Arts,Dance,32,3,29
1984,Fine and Applied Arts,Dance,29,5,24
1985,Fine and Applied Arts,Dance,39,6,33
1986,Fine and Applied Arts,Dance,28,6,22
1986,Fine and Applied Arts,Dance,17,4,13
1987,Fine and Applied Arts,Dance,34,2,32
1987,Fine and Applied Arts,Dance,16,3,13
1988,Fine and Applied Arts,Dance,31,3,28
1988,Fine and Applied Arts,Dance,13,7,6
1989,Fine and Applied Arts,Dance,31,3,28
1989,Fine and Applied Arts,Dance,10,6,4
1990,Fine and Applied Arts,Dance,29,2,27
1990,Fine and Applied Arts,Dance,13,6,7
1991,Fine and Applied Arts,Dance,29,2,27
1991,Fine and Applied Arts,Dance,8,2,6
1992,Fine and Applied Arts,Dance,30,2,28
1992,Fine and Applied Arts,Dance,13,3,10
1993,Fine and Applied Arts,Dance,35,3,32
1993,Fine and Applied Arts,Dance,17,4,13
1994,Fine and Applied Arts,Dance,38,3,35
1994,Fine and Applied Arts,Dance,17,4,13
1995,Fine and Applied Arts,Dance,43,3,40
1995,Fine and Applied Arts,Dance,12,2,10
1996,Fine and Applied Arts,Dance,49,4,45
1996,Fine and Applied Arts,Dance,11,1,10
1997,Fine and Applied Arts,Dance,55,5,50
1997,Fine and Applied Arts,Dance,13,2,11
1998,Fine and Applied Arts,Dance,54,5,49
1998,Fine and Applied Arts,Dance,12,5,7
1999,Fine and Applied Arts,Dance,60,4,56
1999,Fine and Applied Arts,Dance,12,4,8
2000,Fine and Applied Arts,Dance,62,3,59
2000,Fine and Applied Arts,Dance,14,3,11
2001,Fine and Applied Arts,Dance,58,5,53
2001,Fine and Applied Arts,Dance,13,2,11
2002,Fine and Applied Arts,Dance,54,5,49
2002,Fine and Applied Arts,Dance,14,2,12
2003,Fine and Applied Arts,Dance,51,5,46
2003,Fine and Applied Arts,Dance,13,3,10
2018,Fine and Applied Arts,Dance,7,2,5
2018,Fine and Applied Arts,Dance,50,2,48
2018,Fine and Applied Arts,Dance,11,5,6
2017,Fine and Applied Arts,Dance,2,1,1
2017,Fine and Applied Arts,Dance,59,5,54
2017,Fine and Applied Arts,Dance,10,3,7
2016,Fine and Applied Arts,Dance,1,0,1
2016,Fine and Applied Arts,Dance,64,7,57
2016,Fine and Applied Arts,Dance,8,2,6
2015,Fine and Applied Arts,Dance,1,0,1
2015,Fine and Applied Arts,Dance,12,3,9
2015,Fine and Applied Arts,Dance,57,10,47
2014,Fine and Applied Arts,Dance,13,2,11
2014,Fine and Applied Arts,Dance,57,13,44
2013,Fine and Applied Arts,Dance,12,3,9
2013,Fine and Applied Arts,Dance,54,9,45
2012,Fine and Applied Arts,Dance,10,3,7
2012,Fine and Applied Arts,Dance,44,4,40
2011,Fine and Applied Arts,Dance,8,1,7
2011,Fine and Applied Arts,Dance,61,5,56
2010,Fine and Applied Arts,Dance,12,2,10
2010,Fine and Applied Arts,Dance,67,6,61
2009,Fine and Applied Arts,Dance,67,6,61
2009,Fine and Applied Arts,Dance,15,4,11
2008,Fine and Applied Arts,Dance,14,3,11
2008,Fine and Applied Arts,Dance,68,9,59
2007,Fine and Applied Arts,Dance,12,2,10
2007,Fine and Applied Arts,Dance,66,8,58
2006,Fine and Applied Arts,Dance,13,2,11
2006,Fine and Applied Arts,Dance,56,5,51
2005,Fine and Applied Arts,Dance,12,2,10
2005,Fine and Applied Arts,Dance,54,6,48
2004,Fine and Applied Arts,Dance,57,6,51
2004,Fine and Applied Arts,Dance,14,4,10
1981,ACES,DIETETICS,34,1,33
1983,ACES,DIETETICS,69,1,68
1984,ACES,DIETETICS,69,4,65
1985,ACES,DIETETICS,70,2,68
1986,ACES,DIETETICS,81,4,77
1987,ACES,DIETETICS,65,2,63
1988,ACES,DIETETICS,59,2,57
1989,ACES,DIETETICS,55,3,52
1990,ACES,DIETETICS,52,3,49
1991,ACES,DIETETICS,42,3,39
1993,ACES,DIETETICS,66,1,65
1994,ACES,DIETETICS,80,3,77
1995,ACES,DIETETICS,72,2,70
1996,ACES,DIETETICS,91,2,89
1997,ACES,DIETETICS,45,1,44
1998,ACES,DIETETICS,10,1,9
2018,LAS,E Asian Languages & Cultures,33,13,20
2018,LAS,E Asian Languages & Cultures,1,0,1
2018,LAS,E Asian Languages & Cultures,25,7,18
2017,LAS,E Asian Languages & Cultures,35,15,20
2017,LAS,E Asian Languages & Cultures,5,1,4
2017,LAS,E Asian Languages & Cultures,24,9,15
2016,LAS,E Asian Languages & Cultures,45,10,35
2016,LAS,E Asian Languages & Cultures,7,2,5
2016,LAS,E Asian Languages & Cultures,22,8,14
2015,LAS,E Asian Languages & Cultures,4,1,3
2015,LAS,E Asian Languages & Cultures,1,0,1
2015,LAS,E Asian Languages & Cultures,41,14,27
2015,LAS,E Asian Languages & Cultures,24,7,17
2014,LAS,E Asian Languages & Cultures,5,3,2
2014,LAS,E Asian Languages & Cultures,2,0,2
2014,LAS,E Asian Languages & Cultures,53,20,33
2014,LAS,E Asian Languages & Cultures,23,6,17
2013,LAS,E Asian Languages & Cultures,1,1,0
2013,LAS,E Asian Languages & Cultures,21,3,18
2013,LAS,E Asian Languages & Cultures,57,22,35
2012,LAS,E Asian Languages & Cultures,2,1,1
2012,LAS,E Asian Languages & Cultures,1,0,1
2012,LAS,E Asian Languages & Cultures,24,4,20
2012,LAS,E Asian Languages & Cultures,66,32,34
2011,LAS,E Asian Languages & Cultures,1,0,1
2011,LAS,E Asian Languages & Cultures,26,5,21
2011,LAS,E Asian Languages & Cultures,76,30,46
2010,LAS,E Asian Languages & Cultures,30,7,23
2010,LAS,E Asian Languages & Cultures,2,0,2
2010,LAS,E Asian Languages & Cultures,80,34,46
2009,LAS,E Asian Languages & Cultures,72,33,39
2009,LAS,E Asian Languages & Cultures,30,5,25
2008,LAS,E Asian Languages & Cultures,1,1,0
2008,LAS,E Asian Languages & Cultures,73,37,36
2008,LAS,E Asian Languages & Cultures,22,1,21
2007,LAS,E Asian Languages & Cultures,64,35,29
2007,LAS,E Asian Languages & Cultures,26,5,21
2006,LAS,E Asian Languages & Cultures,63,40,23
2006,LAS,E Asian Languages & Cultures,27,5,22
2005,LAS,E Asian Languages & Cultures,1,0,1
2005,LAS,E Asian Languages & Cultures,44,30,14
2005,LAS,E Asian Languages & Cultures,22,5,17
2004,LAS,E Asian Languages & Cultures,35,17,17
2004,LAS,E Asian Languages & Cultures,22,5,17
2001,LAS,E Asian Languages & Cultures,18,3,15
2002,LAS,E Asian Languages & Cultures,26,8,18
2003,LAS,E Asian Languages & Cultures,23,7,16
1983,Education,Early Childhood Education,56,1,55
1984,Education,Early Childhood Education,72,2,70
1985,Education,Early Childhood Education,71,2,69
1990,Education,Early Childhood Education,62,1,61
1992,Education,Early Childhood Education,67,1,66
1993,Education,Early Childhood Education,78,2,76
1994,Education,Early Childhood Education,76,2,74
1995,Education,Early Childhood Education,66,1,65
1996,Education,Early Childhood Education,56,1,55
1997,Education,Early Childhood Education,52,1,51
1998,Education,Early Childhood Education,52,1,51
1999,Education,Early Childhood Education,49,1,48
2000,Education,Early Childhood Education,50,1,49
2001,Education,Early Childhood Education,53,3,50
2002,Education,Early Childhood Education,56,4,52
2003,Education,Early Childhood Education,60,2,58
1998,Education,Early Childhood Education,2,1,1
1999,Education,Early Childhood Education,6,1,5
2001,Education,Early Childhood Education,6,1,5
2002,Education,Early Childhood Education,4,1,3
2003,Education,Early Childhood Education,3,1,2
2018,Education,Early Childhood Education,37,2,35
2018,Education,Early Childhood Education,2,0,2
2018,Education,Early Childhood Education,1,0,1
2018,Education,Early Childhood Education,1,0,1
2018,Education,Early Childhood Education,3,0,3
2018,Education,Early Childhood Education,2,0,2
2018,Education,Early Childhood Education,1,0,1
2018,Education,Early Childhood Education,3,0,3
2018,Education,Early Childhood Education,6,0,6
2017,Education,Early Childhood Education,36,2,34
2017,Education,Early Childhood Education,2,0,2
2017,Education,Early Childhood Education,3,0,3
2017,Education,Early Childhood Education,1,0,1
2017,Education,Early Childhood Education,2,0,2
2017,Education,Early Childhood Education,6,0,6
2017,Education,Early Childhood Education,2,0,2
2017,Education,Early Childhood Education,2,0,2
2017,Education,Early Childhood Education,6,0,6
2017,Education,Early Childhood Education,5,1,4
2016,Education,Early Childhood Education,25,1,24
2016,Education,Early Childhood Education,1,0,1
2016,Education,Early Childhood Education,6,0,6
2016,Education,Early Childhood Education,2,0,2
2016,Education,Early Childhood Education,3,0,3
2016,Education,Early Childhood Education,7,0,7
2016,Education,Early Childhood Education,2,0,2
2016,Education,Early Childhood Education,1,0,1
2016,Education,Early Childhood Education,9,0,9
2016,Education,Early Childhood Education,4,1,3
2015,Education,Early Childhood Education,1,0,1
2015,Education,Early Childhood Education,1,0,1
2015,Education,Early Childhood Education,1,0,1
2015,Education,Early Childhood Education,2,0,2
2015,Education,Early Childhood Education,5,0,5
2015,Education,Early Childhood Education,3,0,3
2015,Education,Early Childhood Education,6,0,6
2015,Education,Early Childhood Education,2,0,2
2015,Education,Early Childhood Education,6,0,6
2015,Education,Early Childhood Education,11,0,11
2015,Education,Early Childhood Education,24,2,22
2014,Education,Early Childhood Education,1,0,1
2014,Education,Early Childhood Education,3,0,3
2014,Education,Early Childhood Education,3,0,3
2014,Education,Early Childhood Education,4,0,4
2014,Education,Early Childhood Education,3,0,3
2014,Education,Early Childhood Education,2,0,2
2014,Education,Early Childhood Education,7,0,7
2013,Education,Early Childhood Education,1,0,1
2013,Education,Early Childhood Education,1,0,1
2013,Education,Early Childhood Education,2,0,2
2013,Education,Early Childhood Education,2,1,1
2013,Education,Early Childhood Education,3,0,3
2013,Education,Early Childhood Education,4,0,4
2013,Education,Early Childhood Education,1,0,1
2013,Education,Early Childhood Education,5,0,5
2013,Education,Early Childhood Education,2,0,2
2013,Education,Early Childhood Education,3,0,3
2012,Education,Early Childhood Education,1,0,1
2012,Education,Early Childhood Education,2,0,2
2012,Education,Early Childhood Education,4,0,4
2012,Education,Early Childhood Education,4,1,3
2012,Education,Early Childhood Education,3,0,3
2012,Education,Early Childhood Education,4,0,4
2012,Education,Early Childhood Education,1,0,1
2012,Education,Early Childhood Education,2,0,2
2012,Education,Early Childhood Education,6,0,6
2012,Education,Early Childhood Education,3,0,3
2011,Education,Early Childhood Education,1,0,1
2011,Education,Early Childhood Education,2,0,2
2011,Education,Early Childhood Education,6,0,6
2011,Education,Early Childhood Education,7,0,7
2011,Education,Early Childhood Education,1,0,1
2011,Education,Early Childhood Education,3,0,3
2011,Education,Early Childhood Education,6,0,6
2011,Education,Early Childhood Education,4,0,4
2011,Education,Early Childhood Education,9,0,9
2010,Education,Early Childhood Education,1,0,1
2010,Education,Early Childhood Education,1,0,1
2010,Education,Early Childhood Education,11,0,11
2010,Education,Early Childhood Education,5,0,5
2010,Education,Early Childhood Education,2,0,2
2010,Education,Early Childhood Education,10,0,10
2010,Education,Early Childhood Education,2,0,2
2010,Education,Early Childhood Education,4,0,4
2010,Education,Early Childhood Education,8,0,8
2009,Education,Early Childhood Education,1,0,1
2009,Education,Early Childhood Education,1,0,1
2009,Education,Early Childhood Education,4,1,3
2009,Education,Early Childhood Education,5,0,5
2009,Education,Early Childhood Education,1,0,1
2009,Education,Early Childhood Education,5,0,5
2009,Education,Early Childhood Education,3,0,3
2009,Education,Early Childhood Education,10,0,10
2009,Education,Early Childhood Education,12,0,12
2008,Education,Early Childhood Education,2,0,2
2008,Education,Early Childhood Education,4,1,3
2008,Education,Early Childhood Education,11,0,11
2008,Education,Early Childhood Education,1,0,1
2008,Education,Early Childhood Education,7,0,7
2008,Education,Early Childhood Education,12,0,11
2008,Education,Early Childhood Education,3,0,3
2008,Education,Early Childhood Education,1,0,1
2008,Education,Early Childhood Education,13,0,13
2008,Education,Early Childhood Education,1,0,1
2008,Education,Early Childhood Education,1,0,1
2007,Education,Early Childhood Education,1,0,1
2007,Education,Early Childhood Education,1,0,1
2007,Education,Early Childhood Education,4,0,4
2007,Education,Early Childhood Education,16,0,16
2007,Education,Early Childhood Education,1,0,1
2007,Education,Early Childhood Education,3,0,3
2007,Education,Early Childhood Education,10,0,9
2007,Education,Early Childhood Education,6,0,6
2007,Education,Early Childhood Education,1,0,1
2007,Education,Early Childhood Education,1,0,1
2007,Education,Early Childhood Education,16,0,16
2007,Education,Early Childhood Education,1,0,1
2006,Education,Early Childhood Education,1,0,1
2006,Education,Early Childhood Education,1,0,1
2006,Education,Early Childhood Education,4,0,4
2006,Education,Early Childhood Education,14,0,14
2006,Education,Early Childhood Education,3,0,3
2006,Education,Early Childhood Education,4,0,4
2006,Education,Early Childhood Education,1,0,1
2006,Education,Early Childhood Education,11,0,11
2006,Education,Early Childhood Education,1,0,1
2006,Education,Early Childhood Education,13,0,13
2005,Education,Early Childhood Education,2,0,2
2005,Education,Early Childhood Education,1,0,1
2005,Education,Early Childhood Education,3,0,3
2005,Education,Early Childhood Education,14,0,14
2005,Education,Early Childhood Education,1,0,1
2005,Education,Early Childhood Education,3,0,3
2005,Education,Early Childhood Education,1,0,1
2005,Education,Early Childhood Education,8,0,8
2005,Education,Early Childhood Education,2,0,2
2005,Education,Early Childhood Education,7,1,6
2005,Education,Early Childhood Education,18,1,17
2004,Education,Early Childhood Education,2,0,2
2004,Education,Early Childhood Education,1,0,1
2004,Education,Early Childhood Education,1,0,1
2004,Education,Early Childhood Education,3,0,3
2004,Education,Early Childhood Education,11,0,11
2004,Education,Early Childhood Education,1,0,1
2004,Education,Early Childhood Education,12,1,11
2004,Education,Early Childhood Education,2,0,2
2004,Education,Early Childhood Education,21,2,19
2004,Education,Early Childhood Education,2,0,2
2004,Education,Early Childhood Education,1,0,1
2004,Education,Early Childhood Education,1,0,1
2004,Education,Early Childhood Education,8,0,8
2004,Education,Early Childhood Education,2,0,2
2016,LAS,"Earth Systems, Env, & Society ",1,0,1
2014,LAS,"Earth Systems, Env, & Society ",1,1,0
2013,LAS,"Earth Systems, Env, & Society ",3,2,1
2013,LAS,"Earth Systems, Env, & Society ",2,1,1
2013,LAS,"Earth Systems, Env, & Society ",5,2,3
2013,LAS,"Earth Systems, Env, & Society ",1,0,1
2012,LAS,"Earth Systems, Env, & Society ",5,2,3
2012,LAS,"Earth Systems, Env, & Society ",1,0,1
2012,LAS,"Earth Systems, Env, & Society ",15,9,6
2012,LAS,"Earth Systems, Env, & Society ",1,1,0
2012,LAS,"Earth Systems, Env, & Society ",14,8,6
2011,LAS,"Earth Systems, Env, & Society ",29,12,17
2011,LAS,"Earth Systems, Env, & Society ",3,0,3
2011,LAS,"Earth Systems, Env, & Society ",1,0,1
2011,LAS,"Earth Systems, Env, & Society ",36,21,15
2011,LAS,"Earth Systems, Env, & Society ",39,22,17
2010,LAS,"Earth Systems, Env, & Society ",1,0,1
2010,LAS,"Earth Systems, Env, & Society ",3,0,3
2010,LAS,"Earth Systems, Env, & Society ",22,11,11
2010,LAS,"Earth Systems, Env, & Society ",53,29,24
2010,LAS,"Earth Systems, Env, & Society ",79,45,34
2009,LAS,"Earth Systems, Env, & Society ",1,0,1
2009,LAS,"Earth Systems, Env, & Society ",33,19,14
2009,LAS,"Earth Systems, Env, & Society ",53,29,24
2009,LAS,"Earth Systems, Env, & Society ",41,20,21
2008,LAS,"Earth Systems, Env, & Society ",4,4,0
2008,LAS,"Earth Systems, Env, & Society ",18,11,7
2008,LAS,"Earth Systems, Env, & Society ",43,22,21
2007,LAS,"Earth Systems, Env, & Society ",1,1,0
2018,LAS,"Earth, Soc, Env Sustainability ",1,0,1
2018,LAS,"Earth, Soc, Env Sustainability ",41,20,21
2018,LAS,"Earth, Soc, Env Sustainability ",11,2,9
2018,LAS,"Earth, Soc, Env Sustainability ",6,3,3
2018,LAS,"Earth, Soc, Env Sustainability ",40,18,22
2018,LAS,"Earth, Soc, Env Sustainability ",4,0,4
2018,LAS,"Earth, Soc, Env Sustainability ",6,0,6
2018,LAS,"Earth, Soc, Env Sustainability ",24,16,8
2018,LAS,"Earth, Soc, Env Sustainability ",2,1,1
2018,LAS,"Earth, Soc, Env Sustainability ",4,3,1
2017,LAS,"Earth, Soc, Env Sustainability ",54,25,29
2017,LAS,"Earth, Soc, Env Sustainability ",11,4,7
2017,LAS,"Earth, Soc, Env Sustainability ",6,5,1
2017,LAS,"Earth, Soc, Env Sustainability ",43,26,17
2017,LAS,"Earth, Soc, Env Sustainability ",6,3,3
2017,LAS,"Earth, Soc, Env Sustainability ",5,1,4
2017,LAS,"Earth, Soc, Env Sustainability ",21,13,8
2017,LAS,"Earth, Soc, Env Sustainability ",1,1,0
2017,LAS,"Earth, Soc, Env Sustainability ",3,2,1
2016,LAS,"Earth, Soc, Env Sustainability ",51,24,27
2016,LAS,"Earth, Soc, Env Sustainability ",14,8,6
2016,LAS,"Earth, Soc, Env Sustainability ",1,0,1
2016,LAS,"Earth, Soc, Env Sustainability ",39,19,20
2016,LAS,"Earth, Soc, Env Sustainability ",7,1,6
2016,LAS,"Earth, Soc, Env Sustainability ",3,0,3
2016,LAS,"Earth, Soc, Env Sustainability ",27,14,13
2016,LAS,"Earth, Soc, Env Sustainability ",7,5,2
2015,LAS,"Earth, Soc, Env Sustainability ",1,0,1
2015,LAS,"Earth, Soc, Env Sustainability ",8,3,5
2015,LAS,"Earth, Soc, Env Sustainability ",10,3,7
2015,LAS,"Earth, Soc, Env Sustainability ",11,5,6
2015,LAS,"Earth, Soc, Env Sustainability ",4,3,1
2015,LAS,"Earth, Soc, Env Sustainability ",15,6,9
2015,LAS,"Earth, Soc, Env Sustainability ",15,6,9
2015,LAS,"Earth, Soc, Env Sustainability ",44,23,21
2015,LAS,"Earth, Soc, Env Sustainability ",44,21,23
2014,LAS,"Earth, Soc, Env Sustainability ",1,0,1
2014,LAS,"Earth, Soc, Env Sustainability ",7,2,5
2014,LAS,"Earth, Soc, Env Sustainability ",2,1,1
2014,LAS,"Earth, Soc, Env Sustainability ",2,0,2
2014,LAS,"Earth, Soc, Env Sustainability ",37,20,17
2014,LAS,"Earth, Soc, Env Sustainability ",16,8,8
2014,LAS,"Earth, Soc, Env Sustainability ",19,10,9
2014,LAS,"Earth, Soc, Env Sustainability ",18,4,14
2014,LAS,"Earth, Soc, Env Sustainability ",39,19,20
2013,LAS,"Earth, Soc, Env Sustainability ",8,3,5
2013,LAS,"Earth, Soc, Env Sustainability ",11,6,5
2013,LAS,"Earth, Soc, Env Sustainability ",1,1,0
2013,LAS,"Earth, Soc, Env Sustainability ",31,14,17
2013,LAS,"Earth, Soc, Env Sustainability ",46,24,22
2013,LAS,"Earth, Soc, Env Sustainability ",4,2,2
2013,LAS,"Earth, Soc, Env Sustainability ",28,16,12
2012,LAS,"Earth, Soc, Env Sustainability ",14,6,7
2012,LAS,"Earth, Soc, Env Sustainability ",3,1,2
2012,LAS,"Earth, Soc, Env Sustainability ",5,3,2
2012,LAS,"Earth, Soc, Env Sustainability ",2,1,1
2012,LAS,"Earth, Soc, Env Sustainability ",3,1,2
2012,LAS,"Earth, Soc, Env Sustainability ",8,4,4
2012,LAS,"Earth, Soc, Env Sustainability ",26,19,7
2014,LAS,"Earth, Society, & Environment ",1,0,1
2014,LAS,"Earth, Society, & Environment ",1,0,1
2014,LAS,"Earth, Society, & Environment ",1,0,1
2014,LAS,"Earth, Society, & Environment ",5,2,3
2013,LAS,"Earth, Society, & Environment ",3,0,3
2013,LAS,"Earth, Society, & Environment ",1,0,1
2013,LAS,"Earth, Society, & Environment ",4,1,3
2013,LAS,"Earth, Society, & Environment ",7,4,3
2013,LAS,"Earth, Society, & Environment ",1,0,1
2013,LAS,"Earth, Society, & Environment ",15,8,7
2012,LAS,"Earth, Society, & Environment ",12,7,5
2012,LAS,"Earth, Society, & Environment ",2,1,1
2012,LAS,"Earth, Society, & Environment ",18,9,9
2012,LAS,"Earth, Society, & Environment ",17,10,7
2011,LAS,"Earth, Society, & Environment ",5,4,1
2011,LAS,"Earth, Society, & Environment ",11,7,4
2011,LAS,"Earth, Society, & Environment ",1,0,1
2011,LAS,"Earth, Society, & Environment ",8,5,3
2018,LAS,East Asian Studies,11,6,5
2017,LAS,East Asian Studies,11,4,7
2016,LAS,East Asian Studies,9,2,7
2015,LAS,East Asian Studies,18,9,9
2014,LAS,East Asian Studies,16,8,8
2013,LAS,East Asian Studies,11,2,9
2012,LAS,East Asian Studies,6,1,5
2018,LAS,"Ecol, Evol, Conservation Biol ",4,1,3
2018,LAS,"Ecol, Evol, Conservation Biol ",30,10,20
2017,LAS,"Ecol, Evol, Conservation Biol ",4,1,3
2017,LAS,"Ecol, Evol, Conservation Biol ",32,13,19
2016,LAS,"Ecol, Evol, Conservation Biol ",3,1,2
2016,LAS,"Ecol, Evol, Conservation Biol ",35,14,21
2015,LAS,"Ecol, Evol, Conservation Biol ",2,1,1
2015,LAS,"Ecol, Evol, Conservation Biol ",32,13,19
2014,LAS,"Ecol, Evol, Conservation Biol ",1,0,1
2014,LAS,"Ecol, Evol, Conservation Biol ",32,13,19
2013,LAS,"Ecol, Evol, Conservation Biol ",2,0,2
2013,LAS,"Ecol, Evol, Conservation Biol ",30,12,18
2012,LAS,"Ecol, Evol, Conservation Biol ",1,0,1
2012,LAS,"Ecol, Evol, Conservation Biol ",30,10,20
2011,LAS,"Ecol, Evol, Conservation Biol ",2,2,0
2011,LAS,"Ecol, Evol, Conservation Biol ",21,8,13
2010,LAS,"Ecol, Evol, Conservation Biol ",3,3,0
2010,LAS,"Ecol, Evol, Conservation Biol ",19,7,12
2009,LAS,"Ecol, Evol, Conservation Biol ",3,2,1
2009,LAS,"Ecol, Evol, Conservation Biol ",19,7,12
2008,LAS,"Ecol, Evol, Conservation Biol ",3,2,1
2008,LAS,"Ecol, Evol, Conservation Biol ",16,10,6
2004,LAS,"Ecology, Ethology, & Evolution ",3,1,2
2018,LAS,Econometrics & Quant Econ,32,26,6
2018,LAS,Econometrics & Quant Econ,1,0,1
1981,Business,Economics,70,47,23
1981,Business,Economics,113,90,23
1982,Business,Economics,63,47,16
1982,Business,Economics,118,95,23
1983,Business,Economics,50,35,15
1983,Business,Economics,130,110,20
2003,Business,Economics,62,43,19
2003,Business,Economics,89,65,24
2003,Business,Economics,72,52,20
1980,Business,Economics,59,38,21
1980,Business,Economics,101,79,22
1984,Business,Economics,45,30,15
1984,Business,Economics,137,114,23
1985,Business,Economics,38,23,15
1985,Business,Economics,154,132,22
1986,Business,Economics,37,23,14
1986,Business,Economics,176,150,26
1987,Business,Economics,54,34,20
1987,Business,Economics,182,157,25
1988,Business,Economics,62,34,28
1988,Business,Economics,174,144,30
1989,Business,Economics,65,41,24
1989,Business,Economics,183,146,37
1990,Business,Economics,70,47,23
1990,Business,Economics,198,165,33
1991,Business,Economics,58,35,23
1991,Business,Economics,205,167,38
1992,Business,Economics,68,40,28
1992,Business,Economics,214,161,53
1993,Business,Economics,76,40,36
1993,Business,Economics,206,154,52
1994,Business,Economics,59,35,24
1994,Business,Economics,205,150,55
1995,Business,Economics,58,33,25
1995,Business,Economics,208,156,52
1996,Business,Economics,58,38,20
1996,Business,Economics,200,142,58
1997,Business,Economics,50,33,17
1997,Business,Economics,108,72,36
1998,Business,Economics,64,39,25
1998,Business,Economics,109,77,32
1999,Business,Economics,59,43,16
1999,Business,Economics,100,69,31
2000,Business,Economics,70,48,22
2000,Business,Economics,87,64,23
2001,Business,Economics,69,38,31
2001,Business,Economics,84,60,24
2002,Business,Economics,58,38,20
2002,Business,Economics,91,65,26
1980,ACES,Physics,276,262,14
1980,ACES,Physics,86,74,12
1981,ACES,Physics,286,267,19
1981,ACES,Physics,70,58,12
1982,ACES,Physics,272,256,16
1982,ACES,Physics,93,81,12
1983,ACES,Physics,276,258,18
1983,ACES,Physics,94,82,12
1984,ACES,Physics,298,275,23
1984,ACES,Physics,78,66,12
1985,ACES,Physics,310,283,27
1985,ACES,Physics,80,68,12
1986,ACES,Physics,305,278,27
1986,ACES,Physics,59,49,10
1987,ACES,Physics,319,286,33
1987,ACES,Physics,67,59,8
1988,ACES,Physics,304,275,29
1988,ACES,Physics,68,58,10
1989,ACES,Physics,290,258,32
1989,ACES,Physics,73,61,12
1990,ACES,Physics,299,272,27
1990,ACES,Physics,80,66,14
1991,ACES,Physics,300,271,29
1991,ACES,Physics,82,68,14
1992,ACES,Physics,290,267,23
1992,ACES,Physics,75,65,10
1993,ACES,Physics,291,267,24
1993,ACES,Physics,57,52,5
1994,ACES,Physics,246,230,16
1994,ACES,Physics,57,48,9
1995,ACES,Physics,264,250,14
1995,ACES,Physics,48,40,8
1996,ACES,Physics,218,208,10
1996,ACES,Physics,56,49,7
1997,ACES,Physics,225,211,14
1997,ACES,Physics,77,67,10
1998,ACES,Physics,213,200,13
1998,ACES,Physics,62,55,7
1999,ACES,Physics,227,212,15
1999,ACES,Physics,58,49,9
2000,ACES,Physics,231,209,22
2000,ACES,Physics,71,60,11
2001,ACES,Physics,234,208,26
2001,ACES,Physics,73,59,14
2002,ACES,Physics,231,203,28
2002,ACES,Physics,79,65,14
2003,ACES,Physics,273,237,36
2003,ACES,Physics,77,61,16
1997,Business,Economics,77,48,29
1998,Business,Economics,88,64,24
1999,Business,Economics,93,66,27
2000,Business,Economics,93,60,33
2001,Business,Economics,99,64,35
2002,Business,Economics,75,56,19
2007,Business,Economics,1,1,0
2006,Business,Economics,7,6,1
2005,Business,Economics,16,12,4
2004,Business,Economics,30,20,10
2018,LAS,Economics,870,631,239
2018,LAS,Economics,79,56,23
2018,LAS,Economics,1,1,0
2018,LAS,Economics,140,78,62
2018,LAS,Economics,112,68,44
2017,LAS,Economics,899,667,232
2017,LAS,Economics,77,48,29
2017,LAS,Economics,1,0,1
2017,LAS,Economics,144,85,59
2017,LAS,Economics,2,2,0
2017,LAS,Economics,120,75,45
2016,LAS,Economics,887,635,252
2016,LAS,Economics,57,38,19
2016,LAS,Economics,1,1,0
2016,LAS,Economics,136,84,52
2016,LAS,Economics,114,72,42
2015,LAS,Economics,77,52,25
2015,LAS,Economics,114,72,42
2015,LAS,Economics,133,78,55
2015,LAS,Economics,817,602,215
2014,LAS,Economics,2,2,0
2014,LAS,Economics,92,59,33
2014,LAS,Economics,110,72,38
2014,LAS,Economics,149,81,68
2014,LAS,Economics,774,552,222
2013,LAS,Economics,1,0,1
2013,LAS,Economics,2,2,0
2013,LAS,Economics,157,81,76
2013,LAS,Economics,104,67,37
2013,LAS,Economics,86,57,29
2013,LAS,Economics,718,519,199
2012,LAS,Economics,2,1,1
2012,LAS,Economics,92,62,30
2012,LAS,Economics,82,50,32
2012,LAS,Economics,153,80,73
2012,LAS,Economics,639,453,186
2011,LAS,Economics,92,60,32
2011,LAS,Economics,48,31,17
2011,LAS,Economics,149,86,63
2011,LAS,Economics,639,446,193
2010,LAS,Economics,46,33,13
2010,LAS,Economics,148,88,60
2010,LAS,Economics,1,0,1
2010,LAS,Economics,107,71,36
2010,LAS,Economics,604,448,156
2009,LAS,Economics,37,26,10
2009,LAS,Economics,98,63,35
2009,LAS,Economics,112,62,50
2009,LAS,Economics,596,460,136
2008,LAS,Economics,10,8,2
2008,LAS,Economics,83,56,27
2008,LAS,Economics,88,55,33
2008,LAS,Economics,655,494,158
2007,LAS,Economics,14,8,6
2007,LAS,Economics,76,52,24
2007,LAS,Economics,92,58,34
2007,LAS,Economics,746,560,182
2006,LAS,Economics,8,5,3
2006,LAS,Economics,82,56,26
2006,LAS,Economics,91,70,21
2006,LAS,Economics,778,578,197
2005,LAS,Economics,13,10,3
2005,LAS,Economics,81,54,27
2005,LAS,Economics,102,76,26
2005,LAS,Economics,665,512,153
2004,LAS,Economics,559,419,140
2004,LAS,Economics,100,73,27
2004,LAS,Economics,83,59,24
1980,Education,Ed Organization and Leadership,135,65,70
1981,Education,Ed Organization and Leadership,129,57,72
1982,Education,Ed Organization and Leadership,130,55,75
1983,Education,Ed Organization and Leadership,115,49,66
1984,Education,Ed Organization and Leadership,106,52,54
1985,Education,Ed Organization and Leadership,95,44,51
1986,Education,Ed Organization and Leadership,143,72,71
1987,Education,Ed Organization and Leadership,154,77,77
1988,Education,Ed Organization and Leadership,150,66,84
1989,Education,Ed Organization and Leadership,93,35,58
1990,Education,Ed Organization and Leadership,106,40,66
1991,Education,Ed Organization and Leadership,105,35,70
1992,Education,Ed Organization and Leadership,95,33,62
1993,Education,Ed Organization and Leadership,96,40,56
1994,Education,Ed Organization and Leadership,86,39,47
1995,Education,Ed Organization and Leadership,109,45,64
1996,Education,Ed Organization and Leadership,127,50,77
1997,Education,Ed Organization and Leadership,130,51,79
1998,Education,Ed Organization and Leadership,121,41,80
1999,Education,Ed Organization and Leadership,112,44,68
2000,Education,Ed Organization and Leadership,107,46,61
2001,Education,Ed Organization and Leadership,115,56,59
2002,Education,Ed Organization and Leadership,126,52,74
2003,Education,Ed Organization and Leadership,165,75,90
2018,Education,Ed Organization and Leadership,2,2,0
2018,Education,Ed Organization and Leadership,9,5,4
2018,Education,Ed Organization and Leadership,2,0,2
2018,Education,Ed Organization and Leadership,1,1,0
2018,Education,Ed Organization and Leadership,3,1,2
2018,Education,Ed Organization and Leadership,4,0,4
2018,Education,Ed Organization and Leadership,1,1,0
2017,Education,Ed Organization and Leadership,2,2,0
2017,Education,Ed Organization and Leadership,15,9,6
2017,Education,Ed Organization and Leadership,4,2,2
2017,Education,Ed Organization and Leadership,1,1,0
2017,Education,Ed Organization and Leadership,5,1,4
2017,Education,Ed Organization and Leadership,6,0,6
2017,Education,Ed Organization and Leadership,1,1,0
2016,Education,Ed Organization and Leadership,2,2,0
2016,Education,Ed Organization and Leadership,4,2,2
2016,Education,Ed Organization and Leadership,1,1,0
2016,Education,Ed Organization and Leadership,2,1,1
2016,Education,Ed Organization and Leadership,1,0,1
2016,Education,Ed Organization and Leadership,8,3,5
2016,Education,Ed Organization and Leadership,7,0,7
2016,Education,Ed Organization and Leadership,3,1,2
2015,Education,Ed Organization and Leadership,1,0,1
2015,Education,Ed Organization and Leadership,4,3,1
2015,Education,Ed Organization and Leadership,13,2,11
2015,Education,Ed Organization and Leadership,11,2,9
2015,Education,Ed Organization and Leadership,1,0,1
2015,Education,Ed Organization and Leadership,6,2,4
2015,Education,Ed Organization and Leadership,3,1,2
2015,Education,Ed Organization and Leadership,8,4,4
2015,Education,Ed Organization and Leadership,9,4,5
2015,Education,Ed Organization and Leadership,13,4,9
2015,Education,Ed Organization and Leadership,11,2,9
2014,Education,Ed Organization and Leadership,1,1,0
2014,Education,Ed Organization and Leadership,4,2,2
2014,Education,Ed Organization and Leadership,1,0,1
2014,Education,Ed Organization and Leadership,1,0,1
2014,Education,Ed Organization and Leadership,4,2,2
2014,Education,Ed Organization and Leadership,4,3,1
2014,Education,Ed Organization and Leadership,14,7,7
2014,Education,Ed Organization and Leadership,13,4,9
2014,Education,Ed Organization and Leadership,14,6,8
2014,Education,Ed Organization and Leadership,13,2,11
2014,Education,Ed Organization and Leadership,32,8,24
2013,Education,Ed Organization and Leadership,1,0,1
2013,Education,Ed Organization and Leadership,2,1,1
2013,Education,Ed Organization and Leadership,1,1,0
2013,Education,Ed Organization and Leadership,7,4,3
2013,Education,Ed Organization and Leadership,8,2,6
2013,Education,Ed Organization and Leadership,14,2,12
2013,Education,Ed Organization and Leadership,14,6,8
2013,Education,Ed Organization and Leadership,1,0,1
2013,Education,Ed Organization and Leadership,8,3,5
2013,Education,Ed Organization and Leadership,19,9,10
2013,Education,Ed Organization and Leadership,3,0,3
2013,Education,Ed Organization and Leadership,14,4,10
2013,Education,Ed Organization and Leadership,30,6,24
2013,Education,Ed Organization and Leadership,14,8,6
2012,Education,Ed Organization and Leadership,1,0,1
2012,Education,Ed Organization and Leadership,1,0,1
2012,Education,Ed Organization and Leadership,4,1,3
2012,Education,Ed Organization and Leadership,1,0,1
2012,Education,Ed Organization and Leadership,2,0,2
2012,Education,Ed Organization and Leadership,9,6,3
2012,Education,Ed Organization and Leadership,15,5,10
2012,Education,Ed Organization and Leadership,18,7,11
2012,Education,Ed Organization and Leadership,10,5,5
2012,Education,Ed Organization and Leadership,23,12,11
2012,Education,Ed Organization and Leadership,29,3,26
2012,Education,Ed Organization and Leadership,13,7,6
2012,Education,Ed Organization and Leadership,12,4,8
2012,Education,Ed Organization and Leadership,32,11,21
2011,Education,Ed Organization and Leadership,3,1,2
2011,Education,Ed Organization and Leadership,2,0,2
2011,Education,Ed Organization and Leadership,20,12,8
2011,Education,Ed Organization and Leadership,1,0,1
2011,Education,Ed Organization and Leadership,4,2,2
2011,Education,Ed Organization and Leadership,6,5,1
2011,Education,Ed Organization and Leadership,17,6,11
2011,Education,Ed Organization and Leadership,2,1,1
2011,Education,Ed Organization and Leadership,4,1,3
2011,Education,Ed Organization and Leadership,2,2,0
2011,Education,Ed Organization and Leadership,3,2,1
2011,Education,Ed Organization and Leadership,24,6,18
2011,Education,Ed Organization and Leadership,17,9,8
2011,Education,Ed Organization and Leadership,14,7,7
2011,Education,Ed Organization and Leadership,24,5,19
2010,Education,Ed Organization and Leadership,1,1,0
2010,Education,Ed Organization and Leadership,4,3,1
2010,Education,Ed Organization and Leadership,1,1,0
2010,Education,Ed Organization and Leadership,3,1,2
2010,Education,Ed Organization and Leadership,1,0,1
2010,Education,Ed Organization and Leadership,3,2,1
2010,Education,Ed Organization and Leadership,5,2,3
2010,Education,Ed Organization and Leadership,21,7,14
2010,Education,Ed Organization and Leadership,31,18,13
2010,Education,Ed Organization and Leadership,20,11,9
2010,Education,Ed Organization and Leadership,16,5,11
2010,Education,Ed Organization and Leadership,30,4,26
2009,Education,Ed Organization and Leadership,5,2,3
2009,Education,Ed Organization and Leadership,40,21,19
2009,Education,Ed Organization and Leadership,3,0,3
2009,Education,Ed Organization and Leadership,2,1,1
2009,Education,Ed Organization and Leadership,9,4,5
2009,Education,Ed Organization and Leadership,1,0,1
2009,Education,Ed Organization and Leadership,1,0,1
2009,Education,Ed Organization and Leadership,1,1,0
2009,Education,Ed Organization and Leadership,1,1,0
2009,Education,Ed Organization and Leadership,1,1,0
2009,Education,Ed Organization and Leadership,11,4,7
2009,Education,Ed Organization and Leadership,37,11,26
2009,Education,Ed Organization and Leadership,3,1,2
2009,Education,Ed Organization and Leadership,18,1,16
2009,Education,Ed Organization and Leadership,22,11,11
2008,Education,Ed Organization and Leadership,7,2,5
2008,Education,Ed Organization and Leadership,40,13,27
2008,Education,Ed Organization and Leadership,1,0,1
2008,Education,Ed Organization and Leadership,13,5,8
2008,Education,Ed Organization and Leadership,6,1,5
2008,Education,Ed Organization and Leadership,67,23,44
2008,Education,Ed Organization and Leadership,4,2,2
2008,Education,Ed Organization and Leadership,24,12,12
2007,Education,Ed Organization and Leadership,6,1,5
2007,Education,Ed Organization and Leadership,8,3,5
2007,Education,Ed Organization and Leadership,46,17,29
2007,Education,Ed Organization and Leadership,14,5,9
2007,Education,Ed Organization and Leadership,1,0,1
2007,Education,Ed Organization and Leadership,3,1,2
2007,Education,Ed Organization and Leadership,81,22,59
2007,Education,Ed Organization and Leadership,26,14,12
2006,Education,Ed Organization and Leadership,11,2,9
2006,Education,Ed Organization and Leadership,6,3,3
2006,Education,Ed Organization and Leadership,49,14,35
2006,Education,Ed Organization and Leadership,1,0,1
2006,Education,Ed Organization and Leadership,25,11,14
2006,Education,Ed Organization and Leadership,4,0,4
2006,Education,Ed Organization and Leadership,1,0,1
2006,Education,Ed Organization and Leadership,1,1,0
2006,Education,Ed Organization and Leadership,59,19,40
2006,Education,Ed Organization and Leadership,22,12,10
2005,Education,Ed Organization and Leadership,7,1,6
2005,Education,Ed Organization and Leadership,2,1,1
2005,Education,Ed Organization and Leadership,3,0,3
2005,Education,Ed Organization and Leadership,1,0,1
2005,Education,Ed Organization and Leadership,46,18,28
2005,Education,Ed Organization and Leadership,47,15,32
2005,Education,Ed Organization and Leadership,21,12,9
2004,Education,Ed Organization and Leadership,15,4,11
2004,Education,Ed Organization and Leadership,1,0,1
2004,Education,Ed Organization and Leadership,73,29,44
2004,Education,Ed Organization and Leadership,43,15,28
2004,Education,Ed Organization and Leadership,11,3,8
2004,Education,Ed Organization and Leadership,1,0,1
2004,Education,Ed Organization and Leadership,4,2,2
1980,Education,ED POL ST,56,31,25
1981,Education,ED POL ST,63,35,28
1982,Education,ED POL ST,66,33,33
1983,Education,ED POL ST,65,32,33
1984,Education,ED POL ST,58,27,31
1985,Education,ED POL ST,45,20,25
1986,Education,ED POL ST,49,22,27
1987,Education,ED POL ST,57,25,32
1988,Education,ED POL ST,57,29,28
1989,Education,ED POL ST,43,22,21
1990,Education,ED POL ST,42,16,26
1991,Education,ED POL ST,49,17,32
1992,Education,ED POL ST,50,19,31
1993,Education,ED POL ST,64,18,46
1994,Education,ED POL ST,70,18,52
1995,Education,ED POL ST,79,24,55
1996,Education,ED POL ST,77,25,52
1997,Education,ED POL ST,65,22,43
1998,Education,ED POL ST,79,26,53
1999,Education,ED POL ST,80,26,54
2000,Education,ED POL ST,96,32,64
2001,Education,ED POL ST,87,28,59
2002,Education,ED POL ST,96,32,64
2003,Education,ED POL ST,112,38,74
1980,Education,ED SEC&CON,115,48,67
1981,Education,ED SEC&CON,110,40,70
1982,Education,ED SEC&CON,117,44,73
1983,Education,ED SEC&CON,106,38,68
1984,Education,ED SEC&CON,115,44,71
1985,Education,ED SEC&CON,114,44,70
1986,Education,ED SEC&CON,129,51,78
1987,Education,ED SEC&CON,141,56,85
1988,Education,ED SEC&CON,121,47,74
1989,Education,ED SEC&CON,131,46,85
1990,Education,ED SEC&CON,141,49,92
1991,Education,ED SEC&CON,160,55,105
1992,Education,ED SEC&CON,139,48,91
1993,Education,ED SEC&CON,121,43,78
1994,Education,ED SEC&CON,102,44,58
1995,Education,ED SEC&CON,103,41,62
1996,Education,ED SEC&CON,78,30,48
1997,Education,ED SEC&CON,66,23,43
1998,Education,ED SEC&CON,77,25,52
1999,Education,ED SEC&CON,80,19,61
2000,Education,ED SEC&CON,95,25,70
2001,Education,ED SEC&CON,100,27,73
2002,Education,ED SEC&CON,119,37,82
2003,Education,ED SEC&CON,101,31,70
1980,Education,EDUC ELEMENTARY,129,26,103
1981,Education,EDUC ELEMENTARY,141,23,118
1982,Education,EDUC ELEMENTARY,145,16,129
1983,Education,EDUC ELEMENTARY,111,9,102
1984,Education,EDUC ELEMENTARY,120,10,110
1985,Education,EDUC ELEMENTARY,117,16,101
1986,Education,EDUC ELEMENTARY,124,22,102
1987,Education,EDUC ELEMENTARY,135,18,117
1988,Education,EDUC ELEMENTARY,158,22,136
1989,Education,EDUC ELEMENTARY,175,17,158
1990,Education,EDUC ELEMENTARY,182,22,160
1991,Education,EDUC ELEMENTARY,181,22,159
1992,Education,EDUC ELEMENTARY,146,15,131
1993,Education,EDUC ELEMENTARY,136,17,119
1994,Education,EDUC ELEMENTARY,124,16,108
1995,Education,EDUC ELEMENTARY,108,17,91
1996,Education,EDUC ELEMENTARY,77,8,69
1997,Education,EDUC ELEMENTARY,77,8,69
1998,Education,EDUC ELEMENTARY,72,7,65
1999,Education,EDUC ELEMENTARY,84,8,76
2000,Education,EDUC ELEMENTARY,95,9,86
2001,Education,EDUC ELEMENTARY,87,9,78
2002,Education,EDUC ELEMENTARY,107,15,92
2003,Education,EDUC ELEMENTARY,88,12,76
1980,Education,EDUC GEN,116,32,84
1981,Education,EDUC GEN,113,21,92
1982,Education,EDUC GEN,135,27,108
1983,Education,EDUC GEN,131,31,100
1984,Education,EDUC GEN,142,30,112
1985,Education,EDUC GEN,185,44,141
1986,Education,EDUC GEN,187,43,144
1987,Education,EDUC GEN,190,50,140
1988,Education,EDUC GEN,202,50,152
1989,Education,EDUC GEN,208,60,148
1990,Education,EDUC GEN,198,57,141
1991,Education,EDUC GEN,229,66,163
1992,Education,EDUC GEN,190,51,139
1993,Education,EDUC GEN,182,66,116
1994,Education,EDUC GEN,175,61,114
1995,Education,EDUC GEN,198,65,133
1996,Education,EDUC GEN,269,68,201
1997,Education,EDUC GEN,218,33,185
1998,Education,EDUC GEN,194,15,179
1999,Education,EDUC GEN,293,18,275
2000,Education,EDUC GEN,306,40,266
2001,Education,EDUC GEN,265,46,219
2002,Education,EDUC GEN,280,28,252
2003,Education,EDUC GEN,292,24,268
1980,Education,EDUC IDISC,5,2,3
1981,Education,EDUC IDISC,7,4,3
1982,Education,EDUC IDISC,8,5,3
1983,Education,EDUC IDISC,3,2,1
1984,Education,EDUC IDISC,2,1,1
2018,Education,"Educ Policy, Orgzn & Leadrshp ",5,2,3
2018,Education,"Educ Policy, Orgzn & Leadrshp ",6,2,4
2018,Education,"Educ Policy, Orgzn & Leadrshp ",1,1,0
2018,Education,"Educ Policy, Orgzn & Leadrshp ",2,1,1
2018,Education,"Educ Policy, Orgzn & Leadrshp ",2,0,2
2018,Education,"Educ Policy, Orgzn & Leadrshp ",7,4,3
2018,Education,"Educ Policy, Orgzn & Leadrshp ",22,11,11
2018,Education,"Educ Policy, Orgzn & Leadrshp ",1,0,1
2018,Education,"Educ Policy, Orgzn & Leadrshp ",14,6,8
2018,Education,"Educ Policy, Orgzn & Leadrshp ",2,0,2
2018,Education,"Educ Policy, Orgzn & Leadrshp ",24,13,10
2018,Education,"Educ Policy, Orgzn & Leadrshp ",2,1,1
2018,Education,"Educ Policy, Orgzn & Leadrshp ",61,27,34
2018,Education,"Educ Policy, Orgzn & Leadrshp ",2,1,1
2018,Education,"Educ Policy, Orgzn & Leadrshp ",29,10,19
2018,Education,"Educ Policy, Orgzn & Leadrshp ",2,0,2
2018,Education,"Educ Policy, Orgzn & Leadrshp ",80,23,57
2018,Education,"Educ Policy, Orgzn & Leadrshp ",3,2,1
2018,Education,"Educ Policy, Orgzn & Leadrshp ",19,5,14
2018,Education,"Educ Policy, Orgzn & Leadrshp ",39,9,30
2018,Education,"Educ Policy, Orgzn & Leadrshp ",6,2,4
2018,Education,"Educ Policy, Orgzn & Leadrshp ",35,8,27
2018,Education,"Educ Policy, Orgzn & Leadrshp ",3,0,3
2018,Education,"Educ Policy, Orgzn & Leadrshp ",16,3,13
2018,Education,"Educ Policy, Orgzn & Leadrshp ",19,6,13
2018,Education,"Educ Policy, Orgzn & Leadrshp ",3,1,2
2018,Education,"Educ Policy, Orgzn & Leadrshp ",24,6,18
2018,Education,"Educ Policy, Orgzn & Leadrshp ",20,10,10
2018,Education,"Educ Policy, Orgzn & Leadrshp ",2,0,2
2018,Education,"Educ Policy, Orgzn & Leadrshp ",26,3,23
2018,Education,"Educ Policy, Orgzn & Leadrshp ",20,1,19
2018,Education,"Educ Policy, Orgzn & Leadrshp ",1,1,0
2018,Education,"Educ Policy, Orgzn & Leadrshp ",12,3,9
2018,Education,"Educ Policy, Orgzn & Leadrshp ",63,13,49
2018,Education,"Educ Policy, Orgzn & Leadrshp ",2,1,1
2018,Education,"Educ Policy, Orgzn & Leadrshp ",1,0,1
2018,Education,"Educ Policy, Orgzn & Leadrshp ",1,1,0
2018,Education,"Educ Policy, Orgzn & Leadrshp ",2,0,2
2018,Education,"Educ Policy, Orgzn & Leadrshp ",1,1,0
2018,Education,"Educ Policy, Orgzn & Leadrshp ",1,0,1
2018,Education,"Educ Policy, Orgzn & Leadrshp ",4,0,4
2018,Education,"Educ Policy, Orgzn & Leadrshp ",38,15,23
2018,Education,"Educ Policy, Orgzn & Leadrshp ",11,3,8
2018,Education,"Educ Policy, Orgzn & Leadrshp ",23,11,12
2018,Education,"Educ Policy, Orgzn & Leadrshp ",3,3,0
2018,Education,"Educ Policy, Orgzn & Leadrshp ",15,2,13
2018,Education,"Educ Policy, Orgzn & Leadrshp ",3,2,1
2018,Education,"Educ Policy, Orgzn & Leadrshp ",12,5,7
2018,Education,"Educ Policy, Orgzn & Leadrshp ",7,0,7
2018,Education,"Educ Policy, Orgzn & Leadrshp ",2,1,1
2018,Education,"Educ Policy, Orgzn & Leadrshp ",1,0,1
2018,Education,"Educ Policy, Orgzn & Leadrshp ",5,2,3
2017,Education,"Educ Policy, Orgzn & Leadrshp ",5,2,3
2017,Education,"Educ Policy, Orgzn & Leadrshp ",3,0,3
2017,Education,"Educ Policy, Orgzn & Leadrshp ",3,1,2
2017,Education,"Educ Policy, Orgzn & Leadrshp ",1,1,0
2017,Education,"Educ Policy, Orgzn & Leadrshp ",1,0,1
2017,Education,"Educ Policy, Orgzn & Leadrshp ",9,5,4
2017,Education,"Educ Policy, Orgzn & Leadrshp ",18,8,10
2017,Education,"Educ Policy, Orgzn & Leadrshp ",8,2,6
2017,Education,"Educ Policy, Orgzn & Leadrshp ",3,1,2
2017,Education,"Educ Policy, Orgzn & Leadrshp ",4,1,3
2017,Education,"Educ Policy, Orgzn & Leadrshp ",1,1,0
2017,Education,"Educ Policy, Orgzn & Leadrshp ",28,11,17
2017,Education,"Educ Policy, Orgzn & Leadrshp ",13,6,7
2017,Education,"Educ Policy, Orgzn & Leadrshp ",1,0,1
2017,Education,"Educ Policy, Orgzn & Leadrshp ",18,7,11
2017,Education,"Educ Policy, Orgzn & Leadrshp ",6,4,2
2017,Education,"Educ Policy, Orgzn & Leadrshp ",17,5,12
2017,Education,"Educ Policy, Orgzn & Leadrshp ",43,11,32
2017,Education,"Educ Policy, Orgzn & Leadrshp ",30,9,21
2017,Education,"Educ Policy, Orgzn & Leadrshp ",12,3,9
2017,Education,"Educ Policy, Orgzn & Leadrshp ",23,3,20
2017,Education,"Educ Policy, Orgzn & Leadrshp ",24,7,17
2017,Education,"Educ Policy, Orgzn & Leadrshp ",6,0,6
2017,Education,"Educ Policy, Orgzn & Leadrshp ",56,20,36
2017,Education,"Educ Policy, Orgzn & Leadrshp ",51,6,45
2017,Education,"Educ Policy, Orgzn & Leadrshp ",2,0,2
2017,Education,"Educ Policy, Orgzn & Leadrshp ",9,3,6
2017,Education,"Educ Policy, Orgzn & Leadrshp ",47,11,36
2017,Education,"Educ Policy, Orgzn & Leadrshp ",2,1,1
2017,Education,"Educ Policy, Orgzn & Leadrshp ",2,1,1
2017,Education,"Educ Policy, Orgzn & Leadrshp ",1,1,0
2017,Education,"Educ Policy, Orgzn & Leadrshp ",3,1,2
2017,Education,"Educ Policy, Orgzn & Leadrshp ",1,0,1
2017,Education,"Educ Policy, Orgzn & Leadrshp ",1,0,1
2017,Education,"Educ Policy, Orgzn & Leadrshp ",2,1,1
2017,Education,"Educ Policy, Orgzn & Leadrshp ",2,2,0
2017,Education,"Educ Policy, Orgzn & Leadrshp ",1,0,1
2017,Education,"Educ Policy, Orgzn & Leadrshp ",9,2,7
2017,Education,"Educ Policy, Orgzn & Leadrshp ",20,8,12
2017,Education,"Educ Policy, Orgzn & Leadrshp ",4,4,0
2017,Education,"Educ Policy, Orgzn & Leadrshp ",12,1,11
2017,Education,"Educ Policy, Orgzn & Leadrshp ",3,1,2
2017,Education,"Educ Policy, Orgzn & Leadrshp ",7,3,4
2017,Education,"Educ Policy, Orgzn & Leadrshp ",3,0,3
2017,Education,"Educ Policy, Orgzn & Leadrshp ",2,1,1
2017,Education,"Educ Policy, Orgzn & Leadrshp ",1,0,1
2017,Education,"Educ Policy, Orgzn & Leadrshp ",4,2,2
2016,Education,"Educ Policy, Orgzn & Leadrshp ",6,2,4
2016,Education,"Educ Policy, Orgzn & Leadrshp ",2,2,0
2016,Education,"Educ Policy, Orgzn & Leadrshp ",1,1,0
2016,Education,"Educ Policy, Orgzn & Leadrshp ",8,4,4
2016,Education,"Educ Policy, Orgzn & Leadrshp ",13,6,7
2016,Education,"Educ Policy, Orgzn & Leadrshp ",2,1,1
2016,Education,"Educ Policy, Orgzn & Leadrshp ",7,4,3
2016,Education,"Educ Policy, Orgzn & Leadrshp ",2,0,2
2016,Education,"Educ Policy, Orgzn & Leadrshp ",19,5,14
2016,Education,"Educ Policy, Orgzn & Leadrshp ",41,12,29
2016,Education,"Educ Policy, Orgzn & Leadrshp ",12,6,6
2016,Education,"Educ Policy, Orgzn & Leadrshp ",24,5,19
2016,Education,"Educ Policy, Orgzn & Leadrshp ",2,1,1
2016,Education,"Educ Policy, Orgzn & Leadrshp ",1,0,1
2016,Education,"Educ Policy, Orgzn & Leadrshp ",2,0,2
2016,Education,"Educ Policy, Orgzn & Leadrshp ",3,2,1
2016,Education,"Educ Policy, Orgzn & Leadrshp ",1,0,1
2016,Education,"Educ Policy, Orgzn & Leadrshp ",1,0,1
2016,Education,"Educ Policy, Orgzn & Leadrshp ",1,0,1
2016,Education,"Educ Policy, Orgzn & Leadrshp ",1,1,0
2016,Education,"Educ Policy, Orgzn & Leadrshp ",1,1,0
2016,Education,"Educ Policy, Orgzn & Leadrshp ",2,2,0
2016,Education,"Educ Policy, Orgzn & Leadrshp ",2,1,1
2016,Education,"Educ Policy, Orgzn & Leadrshp ",1,0,1
2016,Education,"Educ Policy, Orgzn & Leadrshp ",11,6,5
2016,Education,"Educ Policy, Orgzn & Leadrshp ",16,4,12
2016,Education,"Educ Policy, Orgzn & Leadrshp ",2,2,0
2016,Education,"Educ Policy, Orgzn & Leadrshp ",6,2,4
2016,Education,"Educ Policy, Orgzn & Leadrshp ",1,0,1
2016,Education,"Educ Policy, Orgzn & Leadrshp ",7,3,4
2016,Education,"Educ Policy, Orgzn & Leadrshp ",1,0,1
2016,Education,"Educ Policy, Orgzn & Leadrshp ",1,0,1
2016,Education,"Educ Policy, Orgzn & Leadrshp ",1,1,0
2015,Education,"Educ Policy, Orgzn & Leadrshp ",1,1,0
2015,Education,"Educ Policy, Orgzn & Leadrshp ",1,0,1
2015,Education,"Educ Policy, Orgzn & Leadrshp ",2,0,2
2015,Education,"Educ Policy, Orgzn & Leadrshp ",2,2,0
2015,Education,"Educ Policy, Orgzn & Leadrshp ",22,7,15
2015,Education,"Educ Policy, Orgzn & Leadrshp ",2,0,2
2015,Education,"Educ Policy, Orgzn & Leadrshp ",1,1,0
2015,Education,"Educ Policy, Orgzn & Leadrshp ",1,0,1
2015,Education,"Educ Policy, Orgzn & Leadrshp ",1,0,1
2015,Education,"Educ Policy, Orgzn & Leadrshp ",4,1,3
2015,Education,"Educ Policy, Orgzn & Leadrshp ",7,6,1
2015,Education,"Educ Policy, Orgzn & Leadrshp ",4,0,4
2015,Education,"Educ Policy, Orgzn & Leadrshp ",13,4,9
2015,Education,"Educ Policy, Orgzn & Leadrshp ",10,4,6
2015,Education,"Educ Policy, Orgzn & Leadrshp ",6,2,4
2015,Education,"Educ Policy, Orgzn & Leadrshp ",18,5,13
1980,Education,Educ Voc Tech,120,59,61
1981,Education,Educ Voc Tech,115,54,61
1982,Education,Educ Voc Tech,113,55,58
1983,Education,Educ Voc Tech,109,61,48
1984,Education,Educ Voc Tech,104,53,51
1985,Education,Educ Voc Tech,113,63,50
1986,Education,Educ Voc Tech,107,52,55
1987,Education,Educ Voc Tech,91,44,47
1988,Education,Educ Voc Tech,87,44,43
1989,Education,Educ Voc Tech,68,32,36
1990,Education,Educ Voc Tech,60,27,33
1991,Education,Educ Voc Tech,69,33,36
1992,Education,Educ Voc Tech,69,33,36
1993,Education,Educ Voc Tech,68,37,31
1994,Education,Educ Voc Tech,68,33,35
1995,Education,Educ Voc Tech,77,32,45
1996,Education,Educ Voc Tech,92,33,59
1997,Education,Educ Voc Tech,83,31,52
1998,Education,Educ Voc Tech,77,32,45
1999,Education,Educ Voc Tech,77,28,49
2000,Education,Educ Voc Tech,87,37,50
2001,Education,Educ Voc Tech,116,43,73
2002,Education,Educ Voc Tech,104,41,63
2003,Education,Educ Voc Tech,86,37,49
2013,Education,Educ Voc Tech,1,0,1
2012,Education,Educ Voc Tech,1,0,1
2006,Education,Educ Voc Tech,1,0,1
2006,Education,Educ Voc Tech,1,0,1
2006,Education,Educ Voc Tech,8,5,3
2006,Education,Educ Voc Tech,4,0,4
2006,Education,Educ Voc Tech,17,2,15
2006,Education,Educ Voc Tech,38,15,23
2005,Education,Educ Voc Tech,1,0,1
2005,Education,Educ Voc Tech,9,5,4
2005,Education,Educ Voc Tech,7,0,7
2005,Education,Educ Voc Tech,5,1,4
2005,Education,Educ Voc Tech,26,4,22
2005,Education,Educ Voc Tech,47,22,25
2004,Education,Educ Voc Tech,51,24,27
2004,Education,Educ Voc Tech,25,4,21
2004,Education,Educ Voc Tech,4,2,2
1993,ACES,Speech & Hearing Science,10,1,9
1994,ACES,Speech & Hearing Science,51,3,48
1995,ACES,Speech & Hearing Science,57,6,51
1996,ACES,Speech & Hearing Science,35,1,34
1997,ACES,Speech & Hearing Science,34,2,32
1999,ACES,Speech & Hearing Science,9,1,8
2000,ACES,Speech & Hearing Science,12,2,10
2001,ACES,Speech & Hearing Science,13,3,10
2002,ACES,Speech & Hearing Science,17,4,13
2003,ACES,Speech & Hearing Science,18,2,16
1996,ACES,Speech & Hearing Science,23,4,19
1997,ACES,Speech & Hearing Science,20,2,18
1998,ACES,Speech & Hearing Science,50,2,48
1999,ACES,Speech & Hearing Science,51,3,48
2000,ACES,Speech & Hearing Science,49,2,47
2002,ACES,Speech & Hearing Science,62,1,61
2003,ACES,Speech & Hearing Science,51,2,49
1981,ACES,Speech & Hearing Science,7,2,5
1980,ACES,Speech & Hearing Science,69,4,65
1981,ACES,Speech & Hearing Science,60,3,57
1982,ACES,Speech & Hearing Science,52,3,49
1983,ACES,Speech & Hearing Science,52,1,51
1989,ACES,Speech & Hearing Science,58,2,56
1990,ACES,Speech & Hearing Science,52,1,51
1980,ACES,Speech & Hearing Science,35,2,33
1981,ACES,Speech & Hearing Science,24,3,21
1982,ACES,Speech & Hearing Science,35,3,32
1983,ACES,Speech & Hearing Science,26,3,23
1984,ACES,Speech & Hearing Science,22,2,20
1980,ACES,Speech & Hearing Science,54,7,47
1981,ACES,Speech & Hearing Science,48,3,45
1982,ACES,Speech & Hearing Science,44,5,39
1983,ACES,Speech & Hearing Science,44,4,40
1984,ACES,Speech & Hearing Science,45,2,43
1985,ACES,Speech & Hearing Science,37,3,34
1986,ACES,Speech & Hearing Science,31,4,27
1987,ACES,Speech & Hearing Science,48,2,46
1988,ACES,Speech & Hearing Science,54,4,50
1989,ACES,Speech & Hearing Science,46,4,42
1990,ACES,Speech & Hearing Science,60,7,53
1991,ACES,Speech & Hearing Science,66,3,63
1992,ACES,Speech & Hearing Science,63,6,57
1993,ACES,Speech & Hearing Science,51,5,46
1980,ACES,Spanish,46,18,28
1981,ACES,Spanish,49,16,33
1982,ACES,Spanish,46,15,31
1983,ACES,Spanish,36,9,27
1984,ACES,Spanish,46,6,40
1985,ACES,Spanish,45,12,33
1986,ACES,Spanish,46,18,28
1987,ACES,Spanish,43,19,24
1988,ACES,Spanish,52,26,26
1989,ACES,Spanish,69,32,37
1990,ACES,Spanish,67,27,40
1991,ACES,Spanish,68,23,45
1992,ACES,Spanish,55,18,37
1993,ACES,Spanish,47,18,29
1994,ACES,Spanish,49,17,32
1995,ACES,Spanish,47,19,28
1996,ACES,Spanish,48,15,33
1997,ACES,Spanish,50,16,34
1998,ACES,Spanish,55,21,34
1999,ACES,Spanish,49,24,25
2000,ACES,Spanish,49,23,26
2001,ACES,Spanish,53,19,34
2002,ACES,Spanish,64,23,41
2003,ACES,Spanish,58,22,36
1992,ACES,Speech & Hearing Science,64,3,61
1993,ACES,Speech & Hearing Science,125,4,121
1994,ACES,Speech & Hearing Science,149,3,146
1995,ACES,Speech & Hearing Science,158,2,156
1996,ACES,Speech & Hearing Science,165,4,161
1997,ACES,Speech & Hearing Science,186,3,183
1998,ACES,Speech & Hearing Science,145,3,142
2000,ACES,Speech & Hearing Science,156,3,153
2001,ACES,Speech & Hearing Science,183,4,179
2002,ACES,Speech & Hearing Science,201,8,193
2003,ACES,Speech & Hearing Science,216,11,205
2004,Education,Educ Voc Tech,3,2,1
2004,Education,Educ Voc Tech,8,1,7
2012,Education,Education,1,0,1
2006,Education,Education,1,1,0
2006,Education,Education,1,1,0
2005,Education,Education,1,1,0
2005,Education,Education,1,0,1
2005,Education,Education,1,0,1
2005,Education,Education,1,1,0
2005,Education,Education,1,0,1
2005,Education,Education,1,0,1
2018,Education,Education Curriculum Uassign,22,4,18
2017,Education,Education Curriculum Uassign,26,6,20
2007,Education,Education General,1,1,0
2006,Education,Education General,91,8,82
2005,Education,Education General,1,1,0
2005,Education,Education General,284,31,252
2004,Education,Education General,295,29,266
2018,Education,Educational Policy Studies,1,1,0
2018,Education,Educational Policy Studies,38,16,22
2018,Education,Educational Policy Studies,1,1,0
2018,Education,Educational Policy Studies,1,0,1
2017,Education,Educational Policy Studies,1,1,0
1996,ACES,"Recreation, Sport, and Tourism ",11,9,2
1997,ACES,"Recreation, Sport, and Tourism ",44,29,15
1998,ACES,"Recreation, Sport, and Tourism ",80,54,26
1999,ACES,"Recreation, Sport, and Tourism ",93,61,32
2000,ACES,"Recreation, Sport, and Tourism ",104,76,28
2001,ACES,"Recreation, Sport, and Tourism ",106,81,25
2002,ACES,"Recreation, Sport, and Tourism ",166,126,40
2003,ACES,"Recreation, Sport, and Tourism ",153,117,36
1980,ACES,Statistics,11,6,5
1981,ACES,Statistics,10,7,3
1982,ACES,Statistics,15,13,2
1983,ACES,Statistics,16,12,4
1984,ACES,Statistics,31,18,13
1985,ACES,Statistics,36,21,15
1986,ACES,Statistics,46,24,22
1987,ACES,Statistics,54,27,27
1988,ACES,Statistics,69,37,32
1989,ACES,Statistics,56,30,26
1990,ACES,Statistics,52,26,26
1991,ACES,Statistics,49,28,21
1992,ACES,Statistics,36,22,14
1993,ACES,Statistics,29,19,10
1994,ACES,Statistics,27,19,8
1995,ACES,Statistics,20,14,6
1996,ACES,Statistics,19,10,9
1997,ACES,Statistics,17,5,12
1998,ACES,Statistics,15,5,10
1999,ACES,Statistics,20,8,12
2000,ACES,Statistics,12,3,9
2001,ACES,Statistics,19,6,13
2002,ACES,Statistics,25,9,16
2003,ACES,Statistics,24,9,15
2001,ACES,Statistics,2,1,1
2003,ACES,Statistics,3,1,2
2017,Education,Educational Policy Studies,65,25,40
2017,Education,Educational Policy Studies,2,1,1
1984,ACES,Teaching of Biological Science,3,1,2
1985,ACES,Teaching of Biological Science,4,1,3
1989,ACES,Teaching of Biological Science,4,1,3
1990,ACES,Teaching of Biological Science,3,1,2
1991,ACES,Teaching of Biological Science,3,1,2
1992,ACES,Teaching of Biological Science,5,1,4
1993,ACES,Teaching of Biological Science,9,3,6
1994,ACES,Teaching of Biological Science,9,5,4
1995,ACES,Teaching of Biological Science,12,4,8
1996,ACES,Teaching of Biological Science,8,3,5
1997,ACES,Teaching of Biological Science,7,2,5
2016,Education,Educational Policy Studies,1,1,0
2016,Education,Educational Policy Studies,89,36,53
2016,Education,Educational Policy Studies,2,1,1
2015,Education,Educational Policy Studies,1,0,1
2015,Education,Educational Policy Studies,1,0,1
2015,Education,Educational Policy Studies,1,1,0
2015,Education,Educational Policy Studies,6,4,2
2015,Education,Educational Policy Studies,117,43,74
2014,Education,Educational Policy Studies,1,0,1
2014,Education,Educational Policy Studies,2,1,1
2014,Education,Educational Policy Studies,3,1,2
2014,Education,Educational Policy Studies,2,1,1
2014,Education,Educational Policy Studies,10,9,1
2014,Education,Educational Policy Studies,137,52,85
2013,Education,Educational Policy Studies,1,1,0
2013,Education,Educational Policy Studies,2,0,2
2013,Education,Educational Policy Studies,5,1,4
2013,Education,Educational Policy Studies,3,3,0
2013,Education,Educational Policy Studies,11,9,2
2013,Education,Educational Policy Studies,142,51,91
1980,ACES,Teaching of Chemistry,4,1,3
1981,ACES,Teaching of Chemistry,2,1,1
1981,ACES,Teaching of Chemistry,7,4,3
1982,ACES,Teaching of Chemistry,3,2,1
1983,ACES,Teaching of Chemistry,6,3,3
1984,ACES,Teaching of Chemistry,10,4,6
1985,ACES,Teaching of Chemistry,12,6,6
1986,ACES,Teaching of Chemistry,2,1,1
1986,ACES,Teaching of Chemistry,10,7,3
1987,ACES,Teaching of Chemistry,2,1,1
1987,ACES,Teaching of Chemistry,13,8,5
1988,ACES,Teaching of Chemistry,10,6,4
1989,ACES,Teaching of Chemistry,9,3,6
1990,ACES,Teaching of Chemistry,10,4,6
1991,ACES,Teaching of Chemistry,12,6,6
1992,ACES,Teaching of Chemistry,2,1,1
1992,ACES,Teaching of Chemistry,17,10,7
1993,ACES,Teaching of Chemistry,2,1,1
1993,ACES,Teaching of Chemistry,13,7,6
1994,ACES,Teaching of Chemistry,4,1,3
1994,ACES,Teaching of Chemistry,14,8,6
1995,ACES,Teaching of Chemistry,10,5,5
1996,ACES,Teaching of Chemistry,9,4,5
1997,ACES,Teaching of Chemistry,6,4,2
1997,ACES,Teaching of Chemistry,8,3,5
1998,ACES,Teaching of Chemistry,2,1,1
1998,ACES,Teaching of Chemistry,5,3,2
1999,ACES,Teaching of Chemistry,2,1,1
2000,ACES,Teaching of Chemistry,4,2,2
2001,ACES,Teaching of Chemistry,5,1,4
2002,ACES,Teaching of Chemistry,12,3,9
2003,ACES,Teaching of Chemistry,11,3,8
1980,ACES,Teaching of Chemistry,3,2,1
2012,Education,Educational Policy Studies,2,2,0
2012,Education,Educational Policy Studies,8,6,2
2012,Education,Educational Policy Studies,11,6,5
2012,Education,Educational Policy Studies,140,52,88
2011,Education,Educational Policy Studies,1,0,1
2011,Education,Educational Policy Studies,3,1,2
2011,Education,Educational Policy Studies,11,4,7
2011,Education,Educational Policy Studies,120,45,75
2010,Education,Educational Policy Studies,1,0,1
2010,Education,Educational Policy Studies,1,0,1
2010,Education,Educational Policy Studies,3,1,2
2010,Education,Educational Policy Studies,14,8,6
2010,Education,Educational Policy Studies,130,44,86
2009,Education,Educational Policy Studies,2,0,2
2009,Education,Educational Policy Studies,1,0,1
2009,Education,Educational Policy Studies,2,0,2
1985,ACES,Teaching of Earth Science,2,1,1
1997,ACES,Teaching of Earth Science,2,1,1
1998,ACES,Teaching of Earth Science,2,1,1
2009,Education,Educational Policy Studies,13,7,6
2009,Education,Educational Policy Studies,131,46,85
2008,Education,Educational Policy Studies,3,1,2
2008,Education,Educational Policy Studies,1,0,1
2008,Education,Educational Policy Studies,5,3,2
2008,Education,Educational Policy Studies,13,7,6
2008,Education,Educational Policy Studies,116,43,73
2007,Education,Educational Policy Studies,2,0,2
2007,Education,Educational Policy Studies,1,0,1
2007,Education,Educational Policy Studies,2,0,2
2007,Education,Educational Policy Studies,18,8,10
2007,Education,Educational Policy Studies,107,37,70
2006,Education,Educational Policy Studies,1,0,1
2006,Education,Educational Policy Studies,4,1,3
2006,Education,Educational Policy Studies,2,0,2
2006,Education,Educational Policy Studies,25,9,16
2006,Education,Educational Policy Studies,97,36,61
2005,Education,Educational Policy Studies,1,0,1
2005,Education,Educational Policy Studies,6,2,4
2005,Education,Educational Policy Studies,3,1,2
2005,Education,Educational Policy Studies,36,13,23
2005,Education,Educational Policy Studies,89,25,64
2004,Education,Educational Policy Studies,1,1,0
2004,Education,Educational Policy Studies,71,19,52
2004,Education,Educational Policy Studies,29,15,14
2004,Education,Educational Policy Studies,17,6,11
2004,Education,Educational Policy Studies,1,1,0
2004,Education,Educational Policy Studies,13,3,10
1980,Education,Educational Psychology,156,65,91
1981,Education,Educational Psychology,148,69,79
1982,Education,Educational Psychology,172,69,103
1983,Education,Educational Psychology,149,66,83
1984,Education,Educational Psychology,133,57,76
1985,Education,Educational Psychology,138,58,80
1986,Education,Educational Psychology,135,55,80
1987,Education,Educational Psychology,161,57,104
1988,Education,Educational Psychology,160,57,103
1989,Education,Educational Psychology,143,47,96
1990,Education,Educational Psychology,137,42,95
1991,Education,Educational Psychology,128,34,94
1992,Education,Educational Psychology,136,35,101
1993,Education,Educational Psychology,144,39,105
1980,ACES,Teaching of English Sec Lang,75,15,60
1981,ACES,Teaching of English Sec Lang,76,14,62
1982,ACES,Teaching of English Sec Lang,77,18,59
1983,ACES,Teaching of English Sec Lang,77,21,56
1984,ACES,Teaching of English Sec Lang,73,17,56
1985,ACES,Teaching of English Sec Lang,84,21,63
1986,ACES,Teaching of English Sec Lang,75,23,52
1987,ACES,Teaching of English Sec Lang,63,15,48
1988,ACES,Teaching of English Sec Lang,72,17,55
1989,ACES,Teaching of English Sec Lang,72,13,59
1990,ACES,Teaching of English Sec Lang,76,12,64
1991,ACES,Teaching of English Sec Lang,83,22,61
1992,ACES,Teaching of English Sec Lang,90,16,74
1993,ACES,Teaching of English Sec Lang,106,18,88
1994,ACES,Teaching of English Sec Lang,89,14,75
1995,ACES,Teaching of English Sec Lang,85,23,62
1996,ACES,Teaching of English Sec Lang,85,24,61
1997,ACES,Teaching of English Sec Lang,96,29,67
1998,ACES,Teaching of English Sec Lang,64,15,49
1999,ACES,Teaching of English Sec Lang,83,23,60
2000,ACES,Teaching of English Sec Lang,81,26,55
2001,ACES,Teaching of English Sec Lang,64,20,44
2002,ACES,Teaching of English Sec Lang,53,11,42
2003,ACES,Teaching of English Sec Lang,60,12,48
1994,Education,Educational Psychology,136,45,91
1995,Education,Educational Psychology,137,40,97
1996,Education,Educational Psychology,120,37,83
1997,Education,Educational Psychology,113,33,80
1998,Education,Educational Psychology,100,27,73
1999,Education,Educational Psychology,98,28,70
2000,Education,Educational Psychology,99,32,67
2001,Education,Educational Psychology,100,29,71
2002,Education,Educational Psychology,114,41,73
2003,Education,Educational Psychology,136,46,90
2018,Education,Educational Psychology,5,0,5
2018,Education,Educational Psychology,46,14,32
1980,ACES,Teaching of French,14,1,13
1981,ACES,Teaching of French,7,1,6
1982,ACES,Teaching of French,8,1,7
1983,ACES,Teaching of French,10,2,8
1983,ACES,Teaching of French,13,2,11
1984,ACES,Teaching of French,3,2,1
1984,ACES,Teaching of French,17,2,15
1985,ACES,Teaching of French,4,1,3
1985,ACES,Teaching of French,12,2,10
1986,ACES,Teaching of French,16,2,14
1987,ACES,Teaching of French,19,1,18
1988,ACES,Teaching of French,26,2,24
1989,ACES,Teaching of French,17,1,16
1990,ACES,Teaching of French,16,2,14
1991,ACES,Teaching of French,12,2,10
1992,ACES,Teaching of French,15,3,12
1993,ACES,Teaching of French,17,2,15
1996,ACES,Teaching of French,10,3,7
1997,ACES,Teaching of French,7,3,4
1998,ACES,Teaching of French,3,2,1
2017,Education,Educational Psychology,1,0,1
2017,Education,Educational Psychology,14,2,12
2017,Education,Educational Psychology,40,13,27
2017,Education,Educational Psychology,1,0,1
2016,Education,Educational Psychology,11,2,9
2016,Education,Educational Psychology,37,11,26
2016,Education,Educational Psychology,2,0,2
2015,Education,Educational Psychology,1,0,1
2015,Education,Educational Psychology,1,1,0
2015,Education,Educational Psychology,2,1,1
2015,Education,Educational Psychology,3,0,3
2015,Education,Educational Psychology,44,13,31
2014,Education,Educational Psychology,1,0,1
2014,Education,Educational Psychology,2,0,2
2014,Education,Educational Psychology,4,0,4
2014,Education,Educational Psychology,55,17,38
2013,Education,Educational Psychology,70,18,52
2012,Education,Educational Psychology,71,18,53
2011,Education,Educational Psychology,1,0,1
2011,Education,Educational Psychology,1,1,0
1980,ACES,Teaching of German,4,1,3
1980,ACES,Teaching of German,5,1,4
1981,ACES,Teaching of German,5,1,4
1983,ACES,Teaching of German,2,1,1
1983,ACES,Teaching of German,4,1,3
1984,ACES,Teaching of German,4,1,3
1984,ACES,Teaching of German,5,1,4
1985,ACES,Teaching of German,4,1,3
1986,ACES,Teaching of German,4,2,2
1987,ACES,Teaching of German,7,1,6
1988,ACES,Teaching of German,10,3,7
1990,ACES,Teaching of German,7,2,5
1991,ACES,Teaching of German,5,1,4
1995,ACES,Teaching of German,2,1,1
1996,ACES,Teaching of German,5,1,4
1997,ACES,Teaching of German,2,1,1
1998,ACES,Teaching of German,4,1,3
1999,ACES,Teaching of German,3,1,2
2011,Education,Educational Psychology,1,0,1
2011,Education,Educational Psychology,76,17,59
2010,Education,Educational Psychology,1,0,1
2010,Education,Educational Psychology,1,1,0
2010,Education,Educational Psychology,91,26,65
2009,Education,Educational Psychology,1,1,0
2009,Education,Educational Psychology,1,0,1
2009,Education,Educational Psychology,96,28,68
2008,Education,Educational Psychology,2,1,1
2008,Education,Educational Psychology,1,0,1
2008,Education,Educational Psychology,102,30,72
2007,Education,Educational Psychology,1,0,1
2007,Education,Educational Psychology,117,31,86
2006,Education,Educational Psychology,2,0,2
1981,ACES,Teaching of Latin,2,1,1
1982,ACES,Teaching of Latin,5,3,2
1983,ACES,Teaching of Latin,4,1,3
1989,ACES,Teaching of Latin,2,1,1
1990,ACES,Teaching of Latin,2,1,1
1992,ACES,Teaching of Latin,2,1,1
2002,ACES,Teaching of Latin,3,2,1
2003,ACES,Teaching of Latin,5,3,2
2006,Education,Educational Psychology,1,0,1
2006,Education,Educational Psychology,5,1,4
2006,Education,Educational Psychology,124,35,89
2005,Education,Educational Psychology,1,0,1
2005,Education,Educational Psychology,2,0,2
2005,Education,Educational Psychology,1,0,1
2005,Education,Educational Psychology,120,34,86
2004,Education,Educational Psychology,12,4,8
2004,Education,Educational Psychology,1,1,0
2004,Education,Educational Psychology,1,0,1
2004,Education,Educational Psychology,117,35,82
2018,Engineering,Electrical & Computer Engr,89,69,20
2018,Engineering,Electrical & Computer Engr,40,37,3
2018,Engineering,Electrical & Computer Engr,274,225,49
2018,Engineering,Electrical & Computer Engr,1,1,0
2018,Engineering,Electrical & Computer Engr,251,211,40
2018,Engineering,Electrical & Computer Engr,2,2,0
2017,Engineering,Electrical & Computer Engr,94,70,24
1980,ACES,Secondary Education,16,8,8
1980,ACES,Teaching of Mathematics,2,1,1
1980,ACES,Teaching of Mathematics,26,9,17
1981,ACES,Secondary Education,20,8,12
1981,ACES,Teaching of Mathematics,19,6,13
1982,ACES,Secondary Education,21,9,12
1982,ACES,Teaching of Mathematics,3,1,2
1982,ACES,Teaching of Mathematics,23,7,16
1983,ACES,Secondary Education,28,9,19
1983,ACES,Teaching of Mathematics,4,3,1
1983,ACES,Teaching of Mathematics,27,6,21
1984,ACES,Secondary Education,40,12,28
1984,ACES,Teaching of Mathematics,4,3,1
1984,ACES,Teaching of Mathematics,35,10,25
1985,ACES,Secondary Education,47,16,31
1985,ACES,Teaching of Mathematics,4,2,2
1985,ACES,Teaching of Mathematics,31,11,20
1986,ACES,Secondary Education,44,17,27
1986,ACES,Teaching of Mathematics,27,6,21
1987,ACES,Secondary Education,31,18,13
1987,ACES,Teaching of Mathematics,4,1,3
1987,ACES,Teaching of Mathematics,40,10,30
1988,ACES,Secondary Education,32,20,12
1988,ACES,Teaching of Mathematics,49,18,31
1989,ACES,Secondary Education,33,18,15
1989,ACES,Teaching of Mathematics,39,15,24
1990,ACES,Secondary Education,32,12,20
1990,ACES,Teaching of Mathematics,3,2,1
1990,ACES,Teaching of Mathematics,32,8,24
1991,ACES,Secondary Education,31,13,18
1991,ACES,Teaching of Mathematics,3,2,1
1991,ACES,Teaching of Mathematics,28,12,16
1992,ACES,Secondary Education,46,18,28
1992,ACES,Teaching of Mathematics,30,15,15
1993,ACES,Secondary Education,41,17,24
1993,ACES,Teaching of Mathematics,44,20,24
1994,ACES,Secondary Education,32,16,16
1994,ACES,Teaching of Mathematics,37,21,16
1995,ACES,Secondary Education,24,13,11
1995,ACES,Teaching of Mathematics,24,12,12
1996,ACES,Secondary Education,22,8,14
1996,ACES,Teaching of Mathematics,2,1,1
1996,ACES,Teaching of Mathematics,25,11,14
1997,ACES,Secondary Education,29,9,20
1997,ACES,Teaching of Mathematics,2,1,1
1997,ACES,Teaching of Mathematics,18,6,12
1998,ACES,Secondary Education,17,4,13
1998,ACES,Teaching of Mathematics,6,2,4
1998,ACES,Teaching of Mathematics,2,1,1
1999,ACES,Teaching of Mathematics,4,1,3
2000,ACES,Teaching of Mathematics,2,1,1
2017,Engineering,Electrical & Computer Engr,21,19,2
2017,Engineering,Electrical & Computer Engr,248,207,41
1984,ACES,Teaching of Physics,3,2,1
1989,ACES,Teaching of Physics,5,4,1
1991,ACES,Teaching of Physics,3,2,1
1992,ACES,Teaching of Physics,5,3,2
1993,ACES,Teaching of Physics,5,3,2
1994,ACES,Teaching of Physics,6,3,3
1995,ACES,Teaching of Physics,2,1,1
1996,ACES,Teaching of Physics,4,3,1
1997,ACES,Teaching of Physics,4,3,1
2017,Engineering,Electrical & Computer Engr,255,214,41
2017,Engineering,Electrical & Computer Engr,2,2,0
2016,Engineering,Electrical & Computer Engr,68,53,15
2016,Engineering,Electrical & Computer Engr,12,9,3
2016,Engineering,Electrical & Computer Engr,238,194,44
2016,Engineering,Electrical & Computer Engr,267,232,35
2015,Engineering,Electrical & Computer Engr,242,204,38
2015,Engineering,Electrical & Computer Engr,261,225,36
2014,Engineering,Electrical & Computer Engr,267,228,39
2014,Engineering,Electrical & Computer Engr,267,227,40
2013,Engineering,Electrical & Computer Engr,241,204,37
2013,Engineering,Electrical & Computer Engr,253,219,34
2012,Engineering,Electrical & Computer Engr,217,189,28
2012,Engineering,Electrical & Computer Engr,256,221,35
2011,Engineering,Electrical & Computer Engr,2,2,0
2011,Engineering,Electrical & Computer Engr,205,185,20
2011,Engineering,Electrical & Computer Engr,269,230,39
2010,Engineering,Electrical & Computer Engr,2,1,1
2010,Engineering,Electrical & Computer Engr,214,191,23
2010,Engineering,Electrical & Computer Engr,288,244,44
2009,Engineering,Electrical & Computer Engr,1,1,0
2009,Engineering,Electrical & Computer Engr,221,195,26
2009,Engineering,Electrical & Computer Engr,291,250,41
2008,Engineering,Electrical & Computer Engr,1,1,0
2008,Engineering,Electrical & Computer Engr,227,201,26
2008,Engineering,Electrical & Computer Engr,276,242,34
2007,Engineering,Electrical & Computer Engr,2,2,0
2007,Engineering,Electrical & Computer Engr,251,214,37
2007,Engineering,Electrical & Computer Engr,268,232,36
2006,Engineering,Electrical & Computer Engr,50,42,8
2006,Engineering,Electrical & Computer Engr,113,93,20
1980,Engineering,Electrical Engineering,1253,1125,128
1980,Engineering,Electrical Engineering,6,5,1
1980,Engineering,Electrical Engineering,64,58,6
1980,Engineering,Electrical Engineering,322,309,13
1981,Engineering,Electrical Engineering,1177,1043,134
1981,Engineering,Electrical Engineering,10,9,1
1981,Engineering,Electrical Engineering,48,41,7
1981,Engineering,Electrical Engineering,326,309,17
1982,Engineering,Electrical Engineering,1128,1000,128
1982,Engineering,Electrical Engineering,62,48,14
1982,Engineering,Electrical Engineering,317,300,17
1983,Engineering,Electrical Engineering,1206,1061,145
1983,Engineering,Electrical Engineering,67,50,17
1983,Engineering,Electrical Engineering,377,357,20
1984,Engineering,Electrical Engineering,1220,1054,166
1984,Engineering,Electrical Engineering,12,9,3
1984,Engineering,Electrical Engineering,68,53,15
1984,Engineering,Electrical Engineering,455,427,28
1985,Engineering,Electrical Engineering,1373,1189,184
1985,Engineering,Electrical Engineering,17,14,3
1985,Engineering,Electrical Engineering,76,58,18
1985,Engineering,Electrical Engineering,479,450,29
1986,Engineering,Electrical Engineering,1406,1240,166
1986,Engineering,Electrical Engineering,27,22,5
1986,Engineering,Electrical Engineering,84,71,13
1986,Engineering,Electrical Engineering,524,480,44
1987,Engineering,Electrical Engineering,1348,1171,177
1987,Engineering,Electrical Engineering,23,16,7
1987,Engineering,Electrical Engineering,104,94,10
1987,Engineering,Electrical Engineering,529,483,46
1988,Engineering,Electrical Engineering,1251,1088,163
1988,Engineering,Electrical Engineering,29,23,6
1988,Engineering,Electrical Engineering,92,85,7
1988,Engineering,Electrical Engineering,492,449,43
1989,Engineering,Electrical Engineering,1050,912,138
1989,Engineering,Electrical Engineering,19,18,1
1989,Engineering,Electrical Engineering,84,78,6
1989,Engineering,Electrical Engineering,441,398,43
1990,Engineering,Electrical Engineering,1045,920,125
1990,Engineering,Electrical Engineering,18,16,2
1990,Engineering,Electrical Engineering,81,74,7
1990,Engineering,Electrical Engineering,432,394,38
1991,Engineering,Electrical Engineering,969,861,108
1991,Engineering,Electrical Engineering,10,8,2
1991,Engineering,Electrical Engineering,74,66,8
1991,Engineering,Electrical Engineering,463,418,45
1992,Engineering,Electrical Engineering,972,864,108
1992,Engineering,Electrical Engineering,5,4,1
1992,Engineering,Electrical Engineering,80,73,7
1992,Engineering,Electrical Engineering,467,415,52
1980,Business,Teaching of Spanish,24,2,22
1981,Business,Teaching of Spanish,7,1,6
1981,Business,Teaching of Spanish,21,2,19
1982,Business,Teaching of Spanish,9,1,8
1982,Business,Teaching of Spanish,19,1,18
1983,Business,Teaching of Spanish,8,1,7
1983,Business,Teaching of Spanish,15,1,14
1984,Business,Teaching of Spanish,5,1,4
1984,Business,Teaching of Spanish,14,2,12
1985,Business,Teaching of Spanish,10,3,7
1986,Business,Teaching of Spanish,23,4,19
1987,Business,Teaching of Spanish,26,3,23
1988,Business,Teaching of Spanish,2,1,1
1988,Business,Teaching of Spanish,29,3,26
1989,Business,Teaching of Spanish,4,1,3
1989,Business,Teaching of Spanish,26,2,24
1990,Business,Teaching of Spanish,2,1,1
1990,Business,Teaching of Spanish,26,2,24
1991,Business,Teaching of Spanish,3,1,2
1991,Business,Teaching of Spanish,26,2,24
1992,Business,Teaching of Spanish,39,5,34
1993,Business,Teaching of Spanish,43,6,37
1994,Business,Teaching of Spanish,40,4,36
1995,Business,Teaching of Spanish,34,4,30
1996,Business,Teaching of Spanish,27,1,26
2000,Business,Teaching of Spanish,19,5,14
2001,Business,Teaching of Spanish,26,4,22
2002,Business,Teaching of Spanish,26,2,24
2003,Business,Teaching of Spanish,24,4,20
1993,Engineering,Electrical Engineering,988,880,108
1993,Engineering,Electrical Engineering,3,2,1
1993,Engineering,Electrical Engineering,69,60,9
1993,Engineering,Electrical Engineering,449,404,45
1994,Engineering,Electrical Engineering,1009,888,121
1994,Engineering,Electrical Engineering,6,5,1
1994,Engineering,Electrical Engineering,71,65,6
1994,Engineering,Electrical Engineering,447,406,41
1995,Engineering,Electrical Engineering,980,847,133
1995,Engineering,Electrical Engineering,7,4,3
1995,Engineering,Electrical Engineering,80,71,9
1995,Engineering,Electrical Engineering,445,404,41
1996,Engineering,Electrical Engineering,955,820,135
1996,Engineering,Electrical Engineering,88,73,15
1996,Engineering,Electrical Engineering,423,381,42
1997,Engineering,Electrical Engineering,905,780,125
1997,Engineering,Electrical Engineering,6,5,1
1997,Engineering,Electrical Engineering,71,57,14
1997,Engineering,Electrical Engineering,437,400,37
1998,Engineering,Electrical Engineering,859,748,111
1998,Engineering,Electrical Engineering,9,7,2
1998,Engineering,Electrical Engineering,39,35,4
1998,Engineering,Electrical Engineering,448,408,40
1999,Engineering,Electrical Engineering,816,705,111
1999,Engineering,Electrical Engineering,7,6,1
1999,Engineering,Electrical Engineering,22,20,2
1999,Engineering,Electrical Engineering,437,394,43
2000,Engineering,Electrical Engineering,772,645,127
2000,Engineering,Electrical Engineering,6,5,1
2000,Engineering,Electrical Engineering,429,384,45
2001,Engineering,Electrical Engineering,708,580,128
2001,Engineering,Electrical Engineering,5,3,2
2001,Engineering,Electrical Engineering,12,10,2
2001,Engineering,Electrical Engineering,480,424,56
2002,Engineering,Electrical Engineering,742,610,132
2002,Engineering,Electrical Engineering,8,6,2
2002,Engineering,Electrical Engineering,545,469,76
2003,Engineering,Electrical Engineering,836,699,137
2003,Engineering,Electrical Engineering,8,7,1
2003,Engineering,Electrical Engineering,6,4,2
2003,Engineering,Electrical Engineering,573,493,80
2018,Engineering,Electrical Engineering,913,786,127
2017,Engineering,Electrical Engineering,1025,879,146
2016,Engineering,Electrical Engineering,1151,1003,148
2015,Engineering,Electrical Engineering,1146,1002,144
2014,Engineering,Electrical Engineering,1109,973,135
2013,Engineering,Electrical Engineering,1170,1034,135
2012,Engineering,Electrical Engineering,1163,1021,142
2011,Engineering,Electrical Engineering,1128,995,133
1998,Business,Technical Systems Management,2,1,1
1999,Business,Technical Systems Management,6,2,4
2000,Business,Technical Systems Management,5,2,3
2001,Business,Technical Systems Management,5,3,2
1997,Business,Technical Systems Management,37,34,3
1998,Business,Technical Systems Management,48,45,3
1999,Business,Technical Systems Management,52,48,4
2000,Business,Technical Systems Management,56,52,4
2001,Business,Technical Systems Management,66,62,4
2002,Business,Technical Systems Management,72,67,5
2003,Business,Technical Systems Management,74,67,7
1998,Business,Technical Systems Management,19,18,1
2010,Engineering,Electrical Engineering,2,1,1
2010,Engineering,Electrical Engineering,1022,905,115
2009,Engineering,Electrical Engineering,3,2,1
2009,Engineering,Electrical Engineering,942,835,106
2008,Engineering,Electrical Engineering,1,1,0
2008,Engineering,Electrical Engineering,4,3,1
2008,Engineering,Electrical Engineering,799,713,85
2007,Engineering,Electrical Engineering,7,6,1
2007,Engineering,Electrical Engineering,767,685,82
2006,Engineering,Electrical Engineering,165,141,24
2006,Engineering,Electrical Engineering,232,193,39
2006,Engineering,Electrical Engineering,798,711,87
2005,Engineering,Electrical Engineering,5,5,0
2005,Engineering,Electrical Engineering,246,217,29
2005,Engineering,Electrical Engineering,300,253,47
2005,Engineering,Electrical Engineering,855,748,107
2004,Engineering,Electrical Engineering,868,745,123
2004,Engineering,Electrical Engineering,217,193,24
2004,Engineering,Electrical Engineering,8,8,0
2004,Engineering,Electrical Engineering,351,297,54
1980,Education,Elementary Education,428,33,395
1981,Education,Elementary Education,432,27,405
1982,Education,Elementary Education,382,21,361
1983,Education,Elementary Education,370,19,351
1984,Education,Elementary Education,348,17,331
1985,Education,Elementary Education,347,13,334
1986,Education,Elementary Education,388,17,371
1987,Education,Elementary Education,340,11,329
1988,Education,Elementary Education,350,11,339
1989,Education,Elementary Education,343,11,332
1990,Education,Elementary Education,390,11,379
1991,Education,Elementary Education,395,19,376
1992,Education,Elementary Education,377,27,350
1993,Education,Elementary Education,401,32,369
1994,Education,Elementary Education,408,32,376
1995,Education,Elementary Education,375,27,348
1996,Education,Elementary Education,280,13,267
1997,Education,Elementary Education,213,14,199
1998,Education,Elementary Education,221,15,206
1999,Education,Elementary Education,253,20,233
2000,Education,Elementary Education,283,23,260
2001,Education,Elementary Education,303,22,281
2000,Business,Theatre,3,1,2
2002,Business,Theatre,5,2,3
2003,Business,Theatre,4,2,2
1999,Business,Theatre,11,7,4
2000,Business,Theatre,15,8,7
2001,Business,Theatre,10,5,5
2002,Business,Theatre,9,5,4
2003,Business,Theatre,10,6,4
1980,Business,Theatre,36,18,18
1981,Business,Theatre,36,15,21
1982,Business,Theatre,39,19,20
1983,Business,Theatre,37,18,19
1984,Business,Theatre,39,20,19
1985,Business,Theatre,47,22,25
1986,Business,Theatre,48,24,24
1987,Business,Theatre,44,20,24
1988,Business,Theatre,47,22,25
1989,Business,Theatre,50,24,26
1990,Business,Theatre,50,25,25
1991,Business,Theatre,54,25,29
1992,Business,Theatre,57,28,29
1993,Business,Theatre,58,24,34
1994,Business,Theatre,56,25,31
1995,Business,Theatre,52,18,34
1996,Business,Theatre,50,24,26
1997,Business,Theatre,58,27,31
1998,Business,Theatre,52,23,29
1999,Business,Theatre,32,15,17
2000,Business,Theatre,32,13,19
2001,Business,Theatre,28,11,17
2002,Business,Theatre,32,11,21
2003,Business,Theatre,35,16,19
1980,Business,Theatre,9,4,5
1981,Business,Theatre,14,7,7
1982,Business,Theatre,15,8,7
1983,Business,Theatre,16,9,7
1984,Business,Theatre,10,5,5
1985,Business,Theatre,7,6,1
1986,Business,Theatre,10,6,4
1987,Business,Theatre,10,8,2
1988,Business,Theatre,14,9,5
1989,Business,Theatre,16,11,5
1990,Business,Theatre,15,10,5
1991,Business,Theatre,13,8,5
1992,Business,Theatre,13,4,9
1993,Business,Theatre,14,3,11
1994,Business,Theatre,15,5,10
1995,Business,Theatre,15,7,8
1996,Business,Theatre,15,8,7
1997,Business,Theatre,14,6,8
1998,Business,Theatre,15,6,9
1999,Business,Theatre,9,4,5
2000,Business,Theatre,7,2,5
2001,Business,Theatre,8,3,5
2002,Business,Theatre,10,4,6
2003,Business,Theatre,9,3,6
2002,Education,Elementary Education,315,28,287
2003,Education,Elementary Education,289,29,260
1996,Education,Elementary Education,17,6,11
1997,Education,Elementary Education,17,5,12
1998,Education,Elementary Education,16,4,12
1999,Education,Elementary Education,9,2,7
2000,Education,Elementary Education,15,2,13
2001,Education,Elementary Education,16,5,11
2002,Education,Elementary Education,18,5,13
2003,Education,Elementary Education,20,3,17
2018,Education,Elementary Education,294,20,274
2018,Education,Elementary Education,8,3,5
2017,Education,Elementary Education,287,15,272
2017,Education,Elementary Education,3,1,2
2017,Education,Elementary Education,1,0,1
2017,Education,Elementary Education,5,1,4
2016,Education,Elementary Education,242,15,227
1980,Business,Theatre,77,34,43
1981,Business,Theatre,79,41,38
1982,Business,Theatre,84,47,37
1983,Business,Theatre,74,44,30
1984,Business,Theatre,58,33,25
1985,Business,Theatre,46,24,22
1986,Business,Theatre,46,22,24
1987,Business,Theatre,50,24,26
1988,Business,Theatre,58,29,29
1989,Business,Theatre,45,20,25
1990,Business,Theatre,37,19,18
1991,Business,Theatre,50,20,30
1992,Business,Theatre,56,24,32
1993,Business,Theatre,64,26,38
1994,Business,Theatre,66,24,42
1995,Business,Theatre,61,24,37
1996,Business,Theatre,68,28,40
1997,Business,Theatre,76,30,46
1998,Business,Theatre,73,35,38
1999,Business,Theatre,51,28,23
2000,Business,Theatre,46,27,19
2001,Business,Theatre,49,28,21
2002,Business,Theatre,58,29,29
2003,Business,Theatre,70,37,33
1996,Business,Leisure Studies,8,3,5
1997,Business,Leisure Studies,30,9,21
1998,Business,Leisure Studies,46,12,34
1999,Business,Leisure Studies,42,10,32
2000,Business,Leisure Studies,37,13,24
2001,Business,Leisure Studies,41,15,26
2002,Business,Leisure Studies,28,12,16
2003,Business,Leisure Studies,29,3,26
2016,Education,Elementary Education,1,0,1
2016,Education,Elementary Education,2,0,2
2016,Education,Elementary Education,24,2,22
2016,Education,Elementary Education,34,5,29
2016,Education,Elementary Education,2,0,2
2016,Education,Elementary Education,1,0,1
2016,Education,Elementary Education,1,0,1
2016,Education,Elementary Education,7,0,7
2016,Education,Elementary Education,6,0,6
2016,Education,Elementary Education,14,2,12
2016,Education,Elementary Education,1,0,1
2016,Education,Elementary Education,5,0,5
2015,Education,Elementary Education,1,0,1
2015,Education,Elementary Education,2,0,2
2015,Education,Elementary Education,1,0,1
2015,Education,Elementary Education,2,0,2
2015,Education,Elementary Education,1,1,0
2015,Education,Elementary Education,29,1,28
2015,Education,Elementary Education,2,0,2
2015,Education,Elementary Education,6,1,5
2015,Education,Elementary Education,1,0,1
2015,Education,Elementary Education,21,1,20
2015,Education,Elementary Education,13,0,13
2015,Education,Elementary Education,50,2,48
2015,Education,Elementary Education,4,0,4
2015,Education,Elementary Education,1,0,1
2015,Education,Elementary Education,74,11,63
2015,Education,Elementary Education,11,1,10
2015,Education,Elementary Education,159,7,152
2014,Education,Elementary Education,1,0,1
2014,Education,Elementary Education,1,0,1
2014,Education,Elementary Education,1,0,1
2014,Education,Elementary Education,3,0,3
2014,Education,Elementary Education,2,0,2
2014,Education,Elementary Education,21,0,21
2014,Education,Elementary Education,21,0,21
2014,Education,Elementary Education,1,0,1
2014,Education,Elementary Education,45,3,42
2014,Education,Elementary Education,1,0,1
2014,Education,Elementary Education,20,0,20
2014,Education,Elementary Education,1,0,1
2014,Education,Elementary Education,8,2,6
2014,Education,Elementary Education,83,10,73
2014,Education,Elementary Education,7,1,6
2013,Education,Elementary Education,1,0,1
2013,Education,Elementary Education,1,1,0
2013,Education,Elementary Education,75,8,67
2013,Education,Elementary Education,1,0,1
2013,Education,Elementary Education,2,0,2
2013,Education,Elementary Education,1,0,1
2013,Education,Elementary Education,1,0,1
2013,Education,Elementary Education,1,0,1
2013,Education,Elementary Education,1,0,1
2013,Education,Elementary Education,25,0,25
2013,Education,Elementary Education,8,0,8
2013,Education,Elementary Education,12,5,7
2013,Education,Elementary Education,21,1,20
2013,Education,Elementary Education,1,0,1
2013,Education,Elementary Education,3,1,2
2013,Education,Elementary Education,48,5,43
2013,Education,Elementary Education,10,1,9
2012,Education,Elementary Education,1,0,1
2012,Education,Elementary Education,1,0,1
2012,Education,Elementary Education,1,0,1
2012,Education,Elementary Education,2,0,2
2012,Education,Elementary Education,1,0,1
2012,Education,Elementary Education,9,0,9
2012,Education,Elementary Education,3,0,3
2012,Education,Elementary Education,2,0,2
2012,Education,Elementary Education,1,0,1
2012,Education,Elementary Education,1,0,1
2012,Education,Elementary Education,15,1,14
2012,Education,Elementary Education,8,0,8
2012,Education,Elementary Education,1,0,1
2012,Education,Elementary Education,12,3,9
2012,Education,Elementary Education,88,9,79
2012,Education,Elementary Education,34,3,31
2012,Education,Elementary Education,1,0,1
2012,Education,Elementary Education,9,1,8
2012,Education,Elementary Education,65,3,62
2012,Education,Elementary Education,15,2,13
2011,Education,Elementary Education,1,0,1
2011,Education,Elementary Education,1,0,1
2011,Education,Elementary Education,1,0,1
2011,Education,Elementary Education,11,2,9
2011,Education,Elementary Education,3,0,3
2011,Education,Elementary Education,1,0,0
2011,Education,Elementary Education,1,0,1
2011,Education,Elementary Education,14,0,14
2011,Education,Elementary Education,2,0,2
2011,Education,Elementary Education,4,0,4
2011,Education,Elementary Education,14,1,13
2011,Education,Elementary Education,10,1,9
2011,Education,Elementary Education,1,0,1
2011,Education,Elementary Education,7,0,7
2011,Education,Elementary Education,35,4,31
2011,Education,Elementary Education,14,1,13
2011,Education,Elementary Education,100,8,92
2011,Education,Elementary Education,10,1,9
2011,Education,Elementary Education,8,1,7
2011,Education,Elementary Education,68,3,65
2010,Education,Elementary Education,1,0,1
2010,Education,Elementary Education,2,0,2
2010,Education,Elementary Education,1,0,1
2010,Education,Elementary Education,3,0,3
2010,Education,Elementary Education,15,4,11
2010,Education,Elementary Education,1,0,1
2010,Education,Elementary Education,1,0,1
2010,Education,Elementary Education,1,0,0
2010,Education,Elementary Education,1,0,1
2010,Education,Elementary Education,1,0,1
2010,Education,Elementary Education,6,0,6
2010,Education,Elementary Education,36,3,33
2010,Education,Elementary Education,9,0,9
2010,Education,Elementary Education,4,0,4
2010,Education,Elementary Education,1,0,1
2010,Education,Elementary Education,3,0,3
2010,Education,Elementary Education,96,5,91
2010,Education,Elementary Education,1,0,1
2010,Education,Elementary Education,25,3,22
2010,Education,Elementary Education,21,1,20
2010,Education,Elementary Education,11,0,11
2010,Education,Elementary Education,10,2,8
2010,Education,Elementary Education,58,1,57
2009,Education,Elementary Education,2,0,2
2009,Education,Elementary Education,2,0,2
2009,Education,Elementary Education,3,0,3
2009,Education,Elementary Education,14,2,12
2009,Education,Elementary Education,1,0,1
2009,Education,Elementary Education,2,1,1
2009,Education,Elementary Education,33,2,31
2009,Education,Elementary Education,10,0,10
2009,Education,Elementary Education,1,0,1
2009,Education,Elementary Education,6,1,5
2009,Education,Elementary Education,1,0,1
2009,Education,Elementary Education,5,1,4
2009,Education,Elementary Education,1,1,0
2009,Education,Elementary Education,8,0,8
2009,Education,Elementary Education,1,0,1
2009,Education,Elementary Education,11,3,8
2009,Education,Elementary Education,57,3,54
2009,Education,Elementary Education,37,0,37
2009,Education,Elementary Education,85,2,83
2009,Education,Elementary Education,31,4,27
2008,Education,Elementary Education,2,0,2
2008,Education,Elementary Education,3,1,2
2008,Education,Elementary Education,2,1,1
2008,Education,Elementary Education,1,0,1
2008,Education,Elementary Education,14,3,11
2008,Education,Elementary Education,2,1,1
2008,Education,Elementary Education,42,2,40
2008,Education,Elementary Education,6,0,6
2008,Education,Elementary Education,1,0,1
2008,Education,Elementary Education,4,1,3
2008,Education,Elementary Education,1,0,1
2008,Education,Elementary Education,1,0,1
2008,Education,Elementary Education,1,1,0
2008,Education,Elementary Education,2,0,2
2008,Education,Elementary Education,13,3,10
2008,Education,Elementary Education,59,2,57
2008,Education,Elementary Education,80,4,76
2008,Education,Elementary Education,44,1,43
2008,Education,Elementary Education,22,1,21
2008,Education,Elementary Education,4,0,4
2008,Education,Elementary Education,40,5,35
2007,Education,Elementary Education,1,0,1
2007,Education,Elementary Education,2,0,2
2007,Education,Elementary Education,1,1,0
2007,Education,Elementary Education,1,0,1
2007,Education,Elementary Education,15,2,13
2007,Education,Elementary Education,81,9,72
2007,Education,Elementary Education,1,0,1
2007,Education,Elementary Education,38,4,34
2007,Education,Elementary Education,10,1,9
2007,Education,Elementary Education,1,0,1
2007,Education,Elementary Education,4,0,4
2007,Education,Elementary Education,1,0,1
2007,Education,Elementary Education,53,2,51
2007,Education,Elementary Education,1,0,1
2007,Education,Elementary Education,1,1,0
2007,Education,Elementary Education,12,1,11
2007,Education,Elementary Education,58,1,57
2007,Education,Elementary Education,31,1,30
2007,Education,Elementary Education,6,0,6
2007,Education,Elementary Education,6,0,6
2007,Education,Elementary Education,43,4,39
2006,Education,Elementary Education,1,0,1
2006,Education,Elementary Education,2,0,2
2006,Education,Elementary Education,1,0,1
2006,Education,Elementary Education,3,0,3
2006,Education,Elementary Education,1,1,0
2006,Education,Elementary Education,19,2,17
2006,Education,Elementary Education,52,0,51
2006,Education,Elementary Education,1,0,1
2006,Education,Elementary Education,1,0,1
2006,Education,Elementary Education,39,4,35
2006,Education,Elementary Education,14,0,14
2006,Education,Elementary Education,6,0,6
2006,Education,Elementary Education,1,0,1
2006,Education,Elementary Education,11,2,9
2006,Education,Elementary Education,105,9,96
2006,Education,Elementary Education,4,0,4
2006,Education,Elementary Education,54,2,52
2006,Education,Elementary Education,7,0,7
2006,Education,Elementary Education,29,1,28
2006,Education,Elementary Education,38,9,29
2005,Education,Elementary Education,3,1,2
2005,Education,Elementary Education,1,1,0
2005,Education,Elementary Education,1,0,1
2005,Education,Elementary Education,4,0,4
2005,Education,Elementary Education,5,3,2
2005,Education,Elementary Education,19,3,16
2005,Education,Elementary Education,1,0,1
2005,Education,Elementary Education,16,1,15
2005,Education,Elementary Education,4,0,4
2005,Education,Elementary Education,1,0,1
2005,Education,Elementary Education,1,0,1
2005,Education,Elementary Education,15,4,11
2005,Education,Elementary Education,58,1,57
2005,Education,Elementary Education,41,2,39
2005,Education,Elementary Education,55,2,53
2005,Education,Elementary Education,94,6,88
2005,Education,Elementary Education,6,2,4
2005,Education,Elementary Education,30,0,30
2005,Education,Elementary Education,10,0,10
2005,Education,Elementary Education,43,10,33
2004,Education,Elementary Education,1,0,1
2004,Education,Elementary Education,2,0,2
2004,Education,Elementary Education,3,1,2
2004,Education,Elementary Education,1,0,1
2004,Education,Elementary Education,4,0,4
2004,Education,Elementary Education,6,3,3
2004,Education,Elementary Education,24,5,19
2004,Education,Elementary Education,65,4,61
2004,Education,Elementary Education,75,6,69
2004,Education,Elementary Education,2,0,2
2004,Education,Elementary Education,1,1,0
2004,Education,Elementary Education,40,2,38
2004,Education,Elementary Education,17,1,16
2004,Education,Elementary Education,3,0,3
2004,Education,Elementary Education,2,0,2
2004,Education,Elementary Education,46,1,45
2004,Education,Elementary Education,34,5,29
2004,Education,Elementary Education,36,2,34
2004,Education,Elementary Education,22,4,18
2004,Education,Elementary Education,5,0,5
2004,Education,Elementary Education,2,0,2
2004,Education,Elementary Education,14,4,10
2018,Engineering,Engineering,30,23,7
2018,Engineering,Engineering,3,1,2
2018,Engineering,Engineering,1,1,0
2017,Engineering,Engineering,24,22,2
2017,Engineering,Engineering,4,2,2
2016,Engineering,Engineering,25,21,4
2015,Engineering,Engineering,20,14,6
2014,Engineering,Engineering,4,3,1
2018,Engineering,Engineering Mechanics,112,96,16
2017,Engineering,Engineering Mechanics,129,107,22
2016,Engineering,Engineering Mechanics,137,117,20
2015,Engineering,Engineering Mechanics,112,101,11
2014,Engineering,Engineering Mechanics,93,85,8
2013,Engineering,Engineering Mechanics,97,86,11
2012,Engineering,Engineering Mechanics,122,110,12
2011,Engineering,Engineering Mechanics,142,126,16
2010,Engineering,Engineering Mechanics,135,115,20
2009,Engineering,Engineering Mechanics,1,1,0
2009,Engineering,Engineering Mechanics,105,88,17
2008,Engineering,Engineering Mechanics,1,1,0
2008,Engineering,Engineering Mechanics,74,60,13
2007,Engineering,Engineering Mechanics,49,37,12
2006,Engineering,Engineering Mechanics,60,45,15
2006,Engineering,Engineering Mechanics,2,2,0
2005,Engineering,Engineering Mechanics,78,63,15
2004,Engineering,Engineering Mechanics,72,58,14
2018,Engineering,Engineering Physics,275,228,47
2017,Engineering,Engineering Physics,271,230,41
2016,Engineering,Engineering Physics,226,197,29
2015,Engineering,Engineering Physics,248,218,30
2014,Engineering,Engineering Physics,231,210,21
2013,Engineering,Engineering Physics,197,179,18
2012,Engineering,Engineering Physics,177,158,19
2011,Engineering,Engineering Physics,152,138,14
2010,Engineering,Engineering Physics,143,127,16
2009,Engineering,Engineering Physics,139,125,14
2008,Engineering,Engineering Physics,131,118,13
2007,Engineering,Engineering Physics,134,121,13
2006,Engineering,Engineering Physics,124,110,14
2005,Engineering,Engineering Physics,101,87,14
2004,Engineering,Engineering Physics,102,85,17
2018,Engineering,Engineering Undeclared,151,94,57
2017,Engineering,Engineering Undeclared,102,59,42
2016,Engineering,Engineering Undeclared,75,45,30
2015,Engineering,Engineering Undeclared,147,117,30
2014,Engineering,Engineering Undeclared,118,73,45
2013,Engineering,Engineering Undeclared,100,76,24
2018,Education,Accountancy,817,386,431
2018,Education,Accountancy,207,102,105
2018,Education,Accountancy,173,30,143
2018,Education,Accountancy,173,103,70
2018,Education,Accountancy,40,22,18
2018,Education,Accountancy,2,1,1
2018,Education,Accountancy,18,12,6
2017,Education,Accountancy,870,411,459
2017,Education,Accountancy,219,109,110
2017,Education,Accountancy,1,0,1
2017,Education,Accountancy,142,18,124
2017,Education,Accountancy,29,18,11
2017,Education,Accountancy,16,13,3
2017,Education,Accountancy,2,1,1
2017,Education,Accountancy,17,12,5
2016,Education,Accountancy,916,452,464
2016,Education,Accountancy,243,117,126
2016,Education,Accountancy,153,36,117
2016,Education,Accountancy,1,0,1
2016,Education,Accountancy,17,13,4
2015,Education,Accountancy,5,3,2
2015,Education,Accountancy,2,1,1
2015,Education,Accountancy,1,0,1
2015,Education,Accountancy,22,14,8
2015,Education,Accountancy,304,152,152
2015,Education,Accountancy,143,22,121
2015,Education,Accountancy,945,495,450
2014,Education,Accountancy,27,16,11
2014,Education,Accountancy,296,151,145
2014,Education,Accountancy,144,32,112
2014,Education,Accountancy,1023,533,490
2013,Education,Accountancy,142,29,112
2013,Education,Accountancy,26,16,10
2013,Education,Accountancy,274,139,135
2013,Education,Accountancy,989,517,472
2012,Education,Accountancy,2,0,2
2012,Education,Accountancy,136,22,114
2012,Education,Accountancy,21,13,8
2012,Education,Accountancy,245,140,105
2012,Education,Accountancy,962,514,448
2011,Education,Accountancy,1,0,1
2011,Education,Accountancy,146,33,113
2011,Education,Accountancy,21,11,10
2011,Education,Accountancy,187,101,86
2011,Education,Accountancy,942,517,425
2010,Education,Accountancy,137,26,111
2010,Education,Accountancy,10,6,4
2010,Education,Accountancy,26,14,12
2010,Education,Accountancy,225,127,98
2010,Education,Accountancy,875,499,376
2009,Education,Accountancy,1,1,0
2009,Education,Accountancy,27,15,12
2009,Education,Accountancy,3,3,0
2009,Education,Accountancy,69,27,42
2009,Education,Accountancy,26,14,12
2009,Education,Accountancy,166,99,67
2009,Education,Accountancy,123,47,76
2009,Education,Accountancy,774,446,328
2008,Education,Accountancy,1,0,1
2008,Education,Accountancy,1,1,0
2008,Education,Accountancy,32,18,14
2008,Education,Accountancy,26,11,14
2008,Education,Accountancy,154,85,69
2008,Education,Accountancy,23,13,10
2008,Education,Accountancy,210,113,96
2008,Education,Accountancy,104,33,71
2008,Education,Accountancy,596,343,252
2007,Education,Accountancy,2,2,0
2007,Education,Accountancy,30,18,12
2007,Education,Accountancy,14,5,6
2007,Education,Accountancy,158,87,69
2007,Education,Accountancy,23,14,9
2007,Education,Accountancy,200,100,100
2007,Education,Accountancy,78,33,45
2007,Education,Accountancy,615,335,278
2006,Education,Accountancy,1,0,1
2006,Education,Accountancy,40,30,10
2006,Education,Accountancy,51,25,26
2006,Education,Accountancy,22,13,9
2006,Education,Accountancy,125,60,65
2006,Education,Accountancy,138,80,58
2006,Education,Accountancy,84,33,51
2006,Education,Accountancy,761,424,333
2005,Education,Accountancy,20,10,9
2005,Education,Accountancy,36,18,18
2005,Education,Accountancy,56,26,30
2005,Education,Accountancy,85,42,43
2005,Education,Accountancy,112,65,47
2005,Education,Accountancy,24,14,10
2005,Education,Accountancy,80,30,50
2005,Education,Accountancy,848,482,365
2004,Education,Accountancy,842,454,387
2004,Education,Accountancy,55,28,27
2004,Education,Accountancy,3,2,1
2004,Education,Accountancy,100,54,46
2004,Education,Accountancy,56,24,32
2004,Education,Accountancy,76,43,33
2004,Education,Accountancy,48,23,25
2004,Education,Accountancy,21,13,8
2018,Education,ACES Undeclared,55,26,29
2017,Education,ACES Undeclared,6,4,2
2018,Education,Actuarial Science,303,186,117
2018,Education,Actuarial Science,59,23,36
2018,Education,Actuarial Science,36,22,14
2017,Education,Actuarial Science,286,190,96
2017,Education,Actuarial Science,49,24,25
2016,Education,Actuarial Science,293,188,105
2016,Education,Actuarial Science,50,18,32
2015,Education,Actuarial Science,49,20,29
2015,Education,Actuarial Science,340,204,135
2014,Education,Actuarial Science,37,14,23
2014,Education,Actuarial Science,348,204,144
2013,Education,Actuarial Science,1,1,0
2013,Education,Actuarial Science,24,8,16
2013,Education,Actuarial Science,304,177,127
2012,Education,Actuarial Science,2,1,1
2012,Education,Actuarial Science,9,3,6
2012,Education,Actuarial Science,277,165,112
2011,Education,Actuarial Science,4,1,3
2011,Education,Actuarial Science,275,158,117
2010,Education,Actuarial Science,7,4,3
2010,Education,Actuarial Science,285,165,120
2009,Education,Actuarial Science,2,1,1
2009,Education,Actuarial Science,284,173,111
2008,Education,Actuarial Science,3,3,0
2008,Education,Actuarial Science,291,186,105
2007,Education,Actuarial Science,3,2,1
2007,Education,Actuarial Science,278,197,81
2006,Education,Actuarial Science,5,2,3
2006,Education,Actuarial Science,276,187,89
2005,Education,Actuarial Science,4,1,3
2005,Education,Actuarial Science,245,166,79
2004,Education,Actuarial Science,232,152,80
2018,Education,Advertising,626,202,424
2018,Education,Advertising,19,5,14
2017,Education,Advertising,616,202,414
2017,Education,Advertising,16,3,13
2016,Education,Advertising,563,190,373
2016,Education,Advertising,24,3,21
2015,Education,Advertising,27,4,23
2015,Education,Advertising,562,182,380
2014,Education,Advertising,24,4,20
2014,Education,Advertising,579,178,401
2013,Education,Advertising,36,9,27
2013,Education,Advertising,579,162,417
2012,Education,Advertising,38,11,27
2012,Education,Advertising,603,169,434
2011,Education,Advertising,30,7,23
2011,Education,Advertising,626,193,433
2010,Education,Advertising,15,0,15
2010,Education,Advertising,511,158,353
2009,Education,Advertising,16,4,12
2009,Education,Advertising,426,142,283
2008,Education,Advertising,27,6,21
2008,Education,Advertising,433,128,305
2007,Education,Advertising,30,9,21
2007,Education,Advertising,356,90,266
2006,Education,Advertising,27,8,19
2006,Education,Advertising,338,90,248
2005,Education,Advertising,28,8,20
2005,Education,Advertising,235,59,176
2004,Education,Advertising,242,54,188
2004,Education,Advertising,25,7,18
2012,Engineering,Engineering Undesignated,1,0,1
2018,LAS,English,287,69,218
2018,LAS,English,29,5,24
2018,LAS,English,42,15,27
2018,LAS,English,1,0,1
2018,LAS,English,19,7,12
2018,LAS,English,60,21,39
2018,LAS,English,2,0,2
2018,LAS,English,2,2,0
2017,LAS,English,303,82,220
2017,LAS,English,23,1,22
2017,LAS,English,49,14,35
2017,LAS,English,2,1,1
2017,LAS,English,1,0,1
2017,LAS,English,18,7,11
2017,LAS,English,60,21,39
2017,LAS,English,3,0,3
2016,LAS,English,293,84,209
2016,LAS,English,27,4,23
2016,LAS,English,25,5,20
2016,LAS,English,22,9,13
2016,LAS,English,64,22,42
2016,LAS,English,3,0,3
2016,LAS,English,1,0,1
2015,LAS,English,1,0,1
2015,LAS,English,22,5,17
2015,LAS,English,1,0,1
2015,LAS,English,55,10,45
2015,LAS,English,3,0,3
2015,LAS,English,20,10,10
2015,LAS,English,265,84,181
2015,LAS,English,72,26,46
2014,LAS,English,1,0,1
2014,LAS,English,1,1,0
2014,LAS,English,60,13,47
2014,LAS,English,1,0,1
2014,LAS,English,1,0,1
2014,LAS,English,32,6,26
2014,LAS,English,4,0,4
2014,LAS,English,21,10,11
2014,LAS,English,292,90,202
2014,LAS,English,73,23,50
2013,LAS,English,21,10,11
2013,LAS,English,2,1,1
2013,LAS,English,1,0,1
2013,LAS,English,1,0,1
2013,LAS,English,42,5,37
2013,LAS,English,90,28,62
2013,LAS,English,54,12,42
2013,LAS,English,323,106,217
2012,LAS,English,1,0,1
2012,LAS,English,2,0,2
2012,LAS,English,2,1,1
2012,LAS,English,20,7,13
2012,LAS,English,1,0,1
2012,LAS,English,48,12,35
2012,LAS,English,100,32,68
2012,LAS,English,72,16,56
2012,LAS,English,379,126,253
2011,LAS,English,1,0,1
2011,LAS,English,1,1,0
2011,LAS,English,2,1,1
2011,LAS,English,1,0,1
2011,LAS,English,16,5,11
2011,LAS,English,42,13,29
2011,LAS,English,101,32,69
2011,LAS,English,90,21,69
2011,LAS,English,443,141,301
2018,Education,African American Studies,19,5,14
2018,Education,African American Studies,1,1,0
2017,Education,African American Studies,15,4,11
2016,Education,African American Studies,14,5,9
2016,Education,African American Studies,1,0,1
2015,Education,African American Studies,1,1,0
2015,Education,African American Studies,10,2,8
2014,Education,African American Studies,1,1,0
2014,Education,African American Studies,8,3,5
2013,Education,African American Studies,1,1,0
2013,Education,African American Studies,8,3,5
2012,Education,African American Studies,11,5,6
2011,Education,African American Studies,3,3,0
2010,Education,African American Studies,1,0,1
2010,Education,African American Studies,6,4,2
2009,Education,African American Studies,7,1,6
2008,Education,African American Studies,1,1,0
2010,LAS,English,1,0,1
2010,LAS,English,18,6,12
2010,LAS,English,108,32,76
2010,LAS,English,50,18,32
2010,LAS,English,84,22,62
2010,LAS,English,552,184,367
2009,LAS,English,87,21,66
2009,LAS,English,1,1,0
2009,LAS,English,51,22,29
2009,LAS,English,620,200,419
2009,LAS,English,29,11,18
2009,LAS,English,111,35,76
2008,LAS,English,92,19,73
2008,LAS,English,33,14,19
2008,LAS,English,2,2,0
2008,LAS,English,672,206,465
2008,LAS,English,25,8,17
2008,LAS,English,110,39,71
2007,LAS,English,1,0,1
2007,LAS,English,92,20,72
2007,LAS,English,31,13,18
2007,LAS,English,1,1,0
2007,LAS,English,779,240,536
2007,LAS,English,60,22,38
2007,LAS,English,73,25,48
2006,LAS,English,91,14,77
2006,LAS,English,26,15,11
2006,LAS,English,813,259,552
2006,LAS,English,63,25,38
2006,LAS,English,78,27,51
2005,LAS,English,1,1,0
2005,LAS,English,37,20,17
2005,LAS,English,1,0,1
2005,LAS,English,90,15,75
2005,LAS,English,793,245,547
2005,LAS,English,57,25,32
2005,LAS,English,79,27,52
2004,LAS,English,838,279,559
2004,LAS,English,5,1,4
2004,LAS,English,47,5,42
2004,LAS,English,1,0,1
2004,LAS,English,47,22,25
2004,LAS,English,81,29,52
1980,LAS,English,108,50,58
1981,LAS,English,101,51,50
1982,LAS,English,110,50,60
1983,LAS,English,98,43,55
1984,LAS,English,114,51,63
1985,LAS,English,115,54,61
1986,LAS,English,114,54,60
1987,LAS,English,115,57,58
1988,LAS,English,123,62,61
1989,LAS,English,130,63,67
1990,LAS,English,127,53,74
1991,LAS,English,142,63,79
1992,LAS,English,142,65,77
1993,LAS,English,150,65,85
1994,LAS,English,133,56,77
1995,LAS,English,118,48,70
1996,LAS,English,105,43,62
1997,LAS,English,120,48,72
1998,LAS,English,133,52,81
1999,LAS,English,115,43,72
2000,LAS,English,114,44,70
2001,LAS,English,129,52,77
2002,LAS,English,129,50,79
2003,LAS,English,128,52,76
1980,Engineering,ENGR MECH,32,28,4
1981,Engineering,ENGR MECH,44,35,9
1981,Engineering,ENGR MECH,2,1,1
1982,Engineering,ENGR MECH,40,34,6
1982,Engineering,ENGR MECH,2,1,1
1983,Engineering,ENGR MECH,47,38,9
1983,Engineering,ENGR MECH,2,1,1
1984,Engineering,ENGR MECH,45,35,10
1985,Engineering,ENGR MECH,52,43,9
1985,Engineering,ENGR MECH,2,1,1
1986,Engineering,ENGR MECH,55,43,12
1987,Engineering,ENGR MECH,41,34,7
1987,Engineering,ENGR MECH,2,1,1
1988,Engineering,ENGR MECH,58,52,6
1989,Engineering,ENGR MECH,87,76,11
1989,Engineering,ENGR MECH,2,1,1
1990,Engineering,ENGR MECH,87,77,10
1990,Engineering,ENGR MECH,4,3,1
1991,Engineering,ENGR MECH,73,65,8
1991,Engineering,ENGR MECH,3,2,1
1992,Engineering,ENGR MECH,71,62,9
1993,Engineering,ENGR MECH,61,52,9
1994,Engineering,ENGR MECH,54,45,9
1995,Engineering,ENGR MECH,37,30,7
1996,Engineering,ENGR MECH,36,28,8
1997,Engineering,ENGR MECH,34,32,2
1998,Engineering,ENGR MECH,30,27,3
1999,Engineering,ENGR MECH,20,16,4
2000,Engineering,ENGR MECH,16,15,1
2001,Engineering,ENGR MECH,27,19,8
2002,Engineering,ENGR MECH,53,39,14
2003,Engineering,ENGR MECH,62,52,10
1999,Engineering,ENGR NONDEGREE,4,2,2
2000,Engineering,ENGR NONDEGREE,58,51,7
2001,Engineering,ENGR NONDEGREE,70,60,10
2002,Engineering,ENGR NONDEGREE,57,48,9
2003,Engineering,ENGR NONDEGREE,78,65,13
1980,Engineering,ENGR PHYS,99,91,8
1981,Engineering,ENGR PHYS,94,87,7
1982,Engineering,ENGR PHYS,87,78,9
1983,Engineering,ENGR PHYS,80,70,10
1984,Engineering,ENGR PHYS,78,70,8
1985,Engineering,ENGR PHYS,88,74,14
1985,Engineering,ENGR PHYS,3,2,1
1986,Engineering,ENGR PHYS,104,96,8
1987,Engineering,ENGR PHYS,97,82,15
1988,Engineering,ENGR PHYS,106,87,19
1989,Engineering,ENGR PHYS,114,100,14
1990,Engineering,ENGR PHYS,103,88,15
1991,Engineering,ENGR PHYS,106,89,17
1992,Engineering,ENGR PHYS,71,55,16
1993,Engineering,ENGR PHYS,68,50,18
1994,Engineering,ENGR PHYS,70,54,16
1995,Engineering,ENGR PHYS,71,56,15
1996,Engineering,ENGR PHYS,71,56,15
1997,Engineering,ENGR PHYS,66,55,11
1998,Engineering,ENGR PHYS,52,47,5
1999,Engineering,ENGR PHYS,61,51,10
2000,Engineering,ENGR PHYS,64,49,15
2001,Engineering,ENGR PHYS,92,77,15
2002,Engineering,ENGR PHYS,87,74,13
2002,Engineering,ENGR PHYS,3,2,1
2003,Engineering,ENGR PHYS,90,79,11
2018,LAS,Entomology,5,4,1
2018,LAS,Entomology,24,17,7
2017,LAS,Entomology,9,7,2
2017,LAS,Entomology,27,17,10
2016,LAS,Entomology,9,7,2
2016,LAS,Entomology,32,18,14
2015,LAS,Entomology,11,6,5
2015,LAS,Entomology,31,17,14
2014,LAS,Entomology,13,8,5
2014,LAS,Entomology,28,15,13
2013,LAS,Entomology,15,8,7
2013,LAS,Entomology,29,14,15
2012,LAS,Entomology,12,7,5
2012,LAS,Entomology,24,8,16
2011,LAS,Entomology,14,8,6
2011,LAS,Entomology,21,7,14
2010,LAS,Entomology,9,5,4
2010,LAS,Entomology,24,9,15
2009,LAS,Entomology,12,6,6
2009,LAS,Entomology,22,10,12
2008,LAS,Entomology,14,5,9
2008,LAS,Entomology,19,10,9
2007,LAS,Entomology,13,9,4
2007,LAS,Entomology,19,8,11
2006,LAS,Entomology,20,8,12
2006,LAS,Entomology,17,11,6
2005,LAS,Entomology,16,5,11
2005,LAS,Entomology,17,11,6
2004,LAS,Entomology,1,0,1
2004,LAS,Entomology,13,4,9
2004,LAS,Entomology,18,13,5
1980,LAS,Entomology,30,23,7
1981,LAS,Entomology,28,21,7
1982,LAS,Entomology,33,26,7
1983,LAS,Entomology,37,29,8
1984,LAS,Entomology,37,29,8
1985,LAS,Entomology,37,30,7
1986,LAS,Entomology,39,30,9
1987,LAS,Entomology,32,23,9
1988,LAS,Entomology,27,18,9
1989,LAS,Entomology,19,13,6
1990,LAS,Entomology,27,14,13
1991,LAS,Entomology,24,12,12
1992,LAS,Entomology,28,13,15
1993,LAS,Entomology,33,14,19
1994,LAS,Entomology,36,17,19
1995,LAS,Entomology,40,17,23
1996,LAS,Entomology,35,22,13
1997,LAS,Entomology,29,18,11
1998,LAS,Entomology,34,20,14
1999,LAS,Entomology,32,21,11
2000,LAS,Entomology,29,18,11
2001,LAS,Entomology,37,25,12
2002,LAS,Entomology,36,24,12
2003,LAS,Entomology,38,22,16
1980,Engineering,ENV ENGR,33,27,6
1981,Engineering,ENV ENGR,29,26,3
1982,Engineering,ENV ENGR,30,25,5
1983,Engineering,ENV ENGR,31,23,8
1984,Engineering,ENV ENGR,37,30,7
1985,Engineering,ENV ENGR,29,22,7
1986,Engineering,ENV ENGR,32,28,4
1987,Engineering,ENV ENGR,39,30,9
1988,Engineering,ENV ENGR,45,33,12
1989,Engineering,ENV ENGR,37,27,10
1990,Engineering,ENV ENGR,57,45,12
1991,Engineering,ENV ENGR,65,53,12
1992,Engineering,ENV ENGR,81,65,16
1993,Engineering,ENV ENGR,80,66,14
1994,Engineering,ENV ENGR,66,54,12
1995,Engineering,ENV ENGR,72,55,17
1996,Engineering,ENV ENGR,60,48,12
1997,Engineering,ENV ENGR,70,51,19
1998,Engineering,ENV ENGR,65,38,27
1999,Engineering,ENV ENGR,64,42,22
2000,Engineering,ENV ENGR,79,45,34
2001,Engineering,ENV ENGR,79,46,33
2002,Engineering,ENV ENGR,60,36,24
2003,Engineering,ENV ENGR,70,41,29
1981,Engineering,ENV SCI,12,9,3
1982,Engineering,ENV SCI,15,11,4
1983,Engineering,ENV SCI,13,10,3
1984,Engineering,ENV SCI,10,8,2
1985,Engineering,ENV SCI,11,6,5
1986,Engineering,ENV SCI,11,6,5
1987,Engineering,ENV SCI,11,8,3
1988,Engineering,ENV SCI,15,10,5
1989,Engineering,ENV SCI,14,9,5
1990,Engineering,ENV SCI,11,8,3
1991,Engineering,ENV SCI,13,9,4
1992,Engineering,ENV SCI,15,8,7
1993,Engineering,ENV SCI,12,8,4
1994,Engineering,ENV SCI,12,10,2
1995,Engineering,ENV SCI,10,6,4
1996,Engineering,ENV SCI,16,7,9
1997,Engineering,ENV SCI,14,8,6
1998,Engineering,ENV SCI,17,10,7
1999,Engineering,ENV SCI,12,6,6
2000,Engineering,ENV SCI,9,5,4
2001,Engineering,ENV SCI,11,7,4
2002,Engineering,ENV SCI,10,7,3
2003,Engineering,ENV SCI,10,6,4
2018,Engineering,Environ Engr in Civil Engr,58,31,27
2018,Engineering,Environ Engr in Civil Engr,3,1,2
2018,Engineering,Environ Engr in Civil Engr,36,22,14
2018,Engineering,Environ Engr in Civil Engr,2,1,1
2017,Engineering,Environ Engr in Civil Engr,74,28,46
2017,Engineering,Environ Engr in Civil Engr,39,24,15
2017,Engineering,Environ Engr in Civil Engr,2,1,1
2016,Engineering,Environ Engr in Civil Engr,68,22,46
2016,Engineering,Environ Engr in Civil Engr,50,30,20
2015,Engineering,Environ Engr in Civil Engr,45,23,22
2015,Engineering,Environ Engr in Civil Engr,55,23,32
2014,Engineering,Environ Engr in Civil Engr,50,24,26
2014,Engineering,Environ Engr in Civil Engr,68,32,36
2013,Engineering,Environ Engr in Civil Engr,48,24,24
2013,Engineering,Environ Engr in Civil Engr,62,31,31
2012,Engineering,Environ Engr in Civil Engr,48,24,24
2012,Engineering,Environ Engr in Civil Engr,43,20,23
2011,Engineering,Environ Engr in Civil Engr,46,22,24
2011,Engineering,Environ Engr in Civil Engr,50,18,32
2010,Engineering,Environ Engr in Civil Engr,41,21,20
2010,Engineering,Environ Engr in Civil Engr,43,19,24
2009,Engineering,Environ Engr in Civil Engr,36,19,17
2009,Engineering,Environ Engr in Civil Engr,44,21,23
2008,Engineering,Environ Engr in Civil Engr,34,13,21
2008,Engineering,Environ Engr in Civil Engr,41,21,20
2007,Engineering,Environ Engr in Civil Engr,27,12,15
2007,Engineering,Environ Engr in Civil Engr,36,21,15
2006,Engineering,Environ Engr in Civil Engr,24,13,11
2006,Engineering,Environ Engr in Civil Engr,34,21,13
2005,Engineering,Environ Engr in Civil Engr,30,14,16
2005,Engineering,Environ Engr in Civil Engr,31,19,12
2004,Engineering,Environ Engr in Civil Engr,32,16,16
2004,Engineering,Environ Engr in Civil Engr,42,28,14
2017,Engineering,Environ Science in Civil Engr,1,0,1
2016,Engineering,Environ Science in Civil Engr,1,0,1
2015,Engineering,Environ Science in Civil Engr,1,0,1
2014,Engineering,Environ Science in Civil Engr,1,0,1
2013,Engineering,Environ Science in Civil Engr,2,1,1
2013,Engineering,Environ Science in Civil Engr,2,0,2
2012,Engineering,Environ Science in Civil Engr,5,3,2
2012,Engineering,Environ Science in Civil Engr,2,0,2
2011,Engineering,Environ Science in Civil Engr,4,3,1
2011,Engineering,Environ Science in Civil Engr,3,1,2
2010,Engineering,Environ Science in Civil Engr,5,1,4
2010,Engineering,Environ Science in Civil Engr,4,1,3
2009,Engineering,Environ Science in Civil Engr,6,2,4
2009,Engineering,Environ Science in Civil Engr,5,1,4
2008,Engineering,Environ Science in Civil Engr,3,1,2
2008,Engineering,Environ Science in Civil Engr,7,2,5
2007,Engineering,Environ Science in Civil Engr,6,3,3
2007,Engineering,Environ Science in Civil Engr,7,2,5
2006,Engineering,Environ Science in Civil Engr,7,4,3
2006,Engineering,Environ Science in Civil Engr,9,6,3
2005,Engineering,Environ Science in Civil Engr,5,2,3
2005,Engineering,Environ Science in Civil Engr,9,7,2
2004,Engineering,Environ Science in Civil Engr,5,0,5
2004,Engineering,Environ Science in Civil Engr,9,8,1
2018,LAS,European Union Studies,6,3,3
2017,LAS,European Union Studies,10,5,5
2016,LAS,European Union Studies,11,5,6
2015,LAS,European Union Studies,9,4,5
2014,LAS,European Union Studies,8,2,6
2013,LAS,European Union Studies,8,3,5
2012,LAS,European Union Studies,8,4,4
2011,LAS,European Union Studies,8,2,6
2010,LAS,European Union Studies,5,2,3
2003,Business,Executive MBA Program,39,30,9
2003,Business,Executive MBA Program,6,5,1
1997,Business,Executive MBA Program,33,24,9
1998,Business,Executive MBA Program,72,57,15
1999,Business,Executive MBA Program,54,45,9
2000,Business,Executive MBA Program,64,46,18
2001,Business,Executive MBA Program,59,42,17
2002,Business,Executive MBA Program,38,26,12
2001,Business,Executive MBA Program,5,3,2
2002,Business,Executive MBA Program,10,7,3
2004,Business,Executive MBA Program,1,1,0
1980,ACES,EXT EDUC,13,5,8
1981,ACES,EXT EDUC,14,5,9
1982,ACES,EXT EDUC,12,2,10
1983,ACES,EXT EDUC,12,6,6
1984,ACES,EXT EDUC,14,8,6
1985,ACES,EXT EDUC,13,7,6
1986,ACES,EXT EDUC,17,8,9
1987,ACES,EXT EDUC,9,7,2
1988,ACES,EXT EDUC,13,7,6
1989,ACES,EXT EDUC,11,5,6
1990,ACES,EXT EDUC,10,7,3
1991,ACES,EXT EDUC,11,6,5
1992,ACES,EXT EDUC,12,4,8
1993,ACES,EXT EDUC,8,2,6
1994,ACES,EXT EDUC,5,1,4
1984,ACES,FAM&CON EC,15,3,12
1985,ACES,FAM&CON EC,15,6,9
1986,ACES,FAM&CON EC,16,7,9
1987,ACES,FAM&CON EC,17,5,12
1988,ACES,FAM&CON EC,18,6,12
1989,ACES,FAM&CON EC,20,5,15
1990,ACES,FAM&CON EC,18,3,15
1991,ACES,FAM&CON EC,16,3,13
1992,ACES,FAM&CON EC,13,4,9
1993,ACES,FAM&CON EC,8,3,5
1994,ACES,FAM&CON EC,7,2,5
1995,ACES,FAM&CON EC,6,3,3
1996,ACES,FAM&CON EC,7,3,4
1997,ACES,FAM&CON EC,7,2,5
1981,Business,Finance,460,298,162
1981,Business,Finance,48,41,7
1982,Business,Finance,506,306,200
1982,Business,Finance,51,42,9
1983,Business,Finance,556,321,235
1983,Business,Finance,38,29,9
2003,Business,Finance,800,546,254
2003,Business,Finance,21,16,5
2003,Business,Finance,104,78,26
1980,Business,Finance,489,315,174
1980,Business,Finance,47,37,10
1984,Business,Finance,518,293,225
1984,Business,Finance,33,26,7
1985,Business,Finance,573,319,254
1985,Business,Finance,49,39,10
1986,Business,Finance,613,327,286
1986,Business,Finance,51,42,9
1987,Business,Finance,608,348,260
1987,Business,Finance,50,42,8
1988,Business,Finance,626,366,260
1988,Business,Finance,72,54,18
1989,Business,Finance,661,407,254
1989,Business,Finance,78,54,24
1990,Business,Finance,716,480,236
1990,Business,Finance,64,50,14
1991,Business,Finance,629,448,181
1991,Business,Finance,52,42,10
1992,Business,Finance,37,20,17
1992,Business,Finance,483,361,122
1992,Business,Finance,6,5,1
1992,Business,Finance,60,53,7
1993,Business,Finance,15,9,6
1993,Business,Finance,454,325,129
1993,Business,Finance,18,11,7
1993,Business,Finance,59,46,13
1994,Business,Finance,513,373,140
1994,Business,Finance,7,6,1
1994,Business,Finance,18,10,8
1994,Business,Finance,51,34,17
1995,Business,Finance,613,429,184
1995,Business,Finance,6,3,3
1995,Business,Finance,9,4,5
1995,Business,Finance,54,38,16
1996,Business,Finance,601,407,194
1996,Business,Finance,4,2,2
1996,Business,Finance,56,41,15
1997,Business,Finance,697,478,219
1997,Business,Finance,23,18,5
1998,Business,Finance,4,2,2
1998,Business,Finance,773,524,249
1998,Business,Finance,14,10,4
1999,Business,Finance,873,572,301
1999,Business,Finance,15,10,5
2000,Business,Finance,876,565,311
2000,Business,Finance,16,14,2
2001,Business,Finance,907,583,324
2001,Business,Finance,15,12,3
2002,Business,Finance,883,575,308
2002,Business,Finance,17,14,3
1997,Business,Finance,38,26,12
1998,Business,Finance,31,24,7
1999,Business,Finance,57,30,27
2000,Business,Finance,65,43,22
2001,Business,Finance,104,73,31
2002,Business,Finance,116,84,32
2018,Business,Finance,630,450,180
2018,Business,Finance,239,109,130
2018,Business,Finance,18,13,5
2017,Business,Finance,587,430,157
2017,Business,Finance,241,97,144
2017,Business,Finance,17,13,4
2016,Business,Finance,526,364,162
2016,Business,Finance,1,1,0
2016,Business,Finance,175,65,110
2016,Business,Finance,19,15,4
2015,Business,Finance,1,1,0
2015,Business,Finance,18,13,5
2015,Business,Finance,550,382,168
2015,Business,Finance,136,59,77
2014,Business,Finance,1,1,0
2014,Business,Finance,23,16,7
2014,Business,Finance,117,63,54
2014,Business,Finance,485,327,158
2013,Business,Finance,121,61,60
2013,Business,Finance,24,16,8
2013,Business,Finance,460,310,150
2012,Business,Finance,130,67,63
2012,Business,Finance,24,15,9
2012,Business,Finance,501,341,160
2011,Business,Finance,25,15,10
2011,Business,Finance,3,2,1
2011,Business,Finance,142,73,69
2011,Business,Finance,492,358,134
2010,Business,Finance,117,66,51
2010,Business,Finance,22,11,11
2010,Business,Finance,3,3,0
2010,Business,Finance,436,308,128
2009,Business,Finance,21,9,12
2009,Business,Finance,545,393,152
2009,Business,Finance,132,77,55
2008,Business,Finance,2,2,0
2008,Business,Finance,3,1,2
2008,Business,Finance,17,10,7
2008,Business,Finance,598,409,188
2008,Business,Finance,107,74,33
2007,Business,Finance,1,0,1
2007,Business,Finance,1,1,0
2007,Business,Finance,2,1,1
2007,Business,Finance,18,11,7
2007,Business,Finance,551,407,143
2007,Business,Finance,119,64,55
2006,Business,Finance,1,1,0
2006,Business,Finance,3,2,1
2006,Business,Finance,12,6,6
2006,Business,Finance,55,37,18
2006,Business,Finance,588,444,143
2006,Business,Finance,123,77,46
2005,Business,Finance,7,4,3
2005,Business,Finance,2,1,1
2005,Business,Finance,16,11,5
2005,Business,Finance,75,39,34
2005,Business,Finance,796,567,228
2004,Business,Finance,145,94,51
2004,Business,Finance,626,427,199
2004,Business,Finance,2,0,2
2004,Business,Finance,101,55,46
2018,Education,Anthropology,43,19,24
2018,Education,Anthropology,2,1,1
2018,Education,Anthropology,2,0,2
2018,Education,Anthropology,4,2,2
2018,Education,Anthropology,6,3,3
2018,Education,Anthropology,1,1,0
2018,Education,Anthropology,11,3,8
2018,Education,Anthropology,1,0,1
2018,Education,Anthropology,25,5,20
2018,Education,Anthropology,57,16,41
2017,Education,Anthropology,79,28,51
2017,Education,Anthropology,3,2,1
2017,Education,Anthropology,4,1,3
2017,Education,Anthropology,1,1,0
2017,Education,Anthropology,1,0,1
2017,Education,Anthropology,1,0,1
2017,Education,Anthropology,60,16,44
2016,Education,Anthropology,75,28,47
2016,Education,Anthropology,6,2,4
2016,Education,Anthropology,4,3,1
2016,Education,Anthropology,1,0,1
2016,Education,Anthropology,62,18,44
2015,Education,Anthropology,3,2,1
2015,Education,Anthropology,7,1,6
2015,Education,Anthropology,75,24,51
2015,Education,Anthropology,61,16,45
2014,Education,Anthropology,11,0,11
2014,Education,Anthropology,4,0,4
2014,Education,Anthropology,2,1,1
2014,Education,Anthropology,102,29,73
2014,Education,Anthropology,58,16,42
2013,Education,Anthropology,10,0,10
2013,Education,Anthropology,4,0,4
2013,Education,Anthropology,3,1,2
2013,Education,Anthropology,56,16,40
2013,Education,Anthropology,126,41,85
2012,Education,Anthropology,10,5,5
2012,Education,Anthropology,8,4,4
2012,Education,Anthropology,3,1,2
2012,Education,Anthropology,1,0,1
2012,Education,Anthropology,56,19,37
2012,Education,Anthropology,148,40,108
2011,Education,Anthropology,7,2,5
2011,Education,Anthropology,7,3,4
2011,Education,Anthropology,1,1,0
2011,Education,Anthropology,3,1,2
2011,Education,Anthropology,55,16,39
2011,Education,Anthropology,132,41,91
2010,Education,Anthropology,9,5,4
2010,Education,Anthropology,4,0,4
2010,Education,Anthropology,1,1,0
2010,Education,Anthropology,3,0,3
2010,Education,Anthropology,53,17,36
2010,Education,Anthropology,131,46,85
2009,Education,Anthropology,8,1,7
2009,Education,Anthropology,6,5,1
2009,Education,Anthropology,2,1,1
2009,Education,Anthropology,3,0,3
2009,Education,Anthropology,136,35,101
2009,Education,Anthropology,62,25,37
2008,Education,Anthropology,5,1,4
2008,Education,Anthropology,2,1,1
2008,Education,Anthropology,2,0,2
2008,Education,Anthropology,175,58,117
2008,Education,Anthropology,59,21,38
2007,Education,Anthropology,2,0,2
2007,Education,Anthropology,5,1,4
2007,Education,Anthropology,1,0,1
2007,Education,Anthropology,153,52,101
2007,Education,Anthropology,59,21,38
2006,Education,Anthropology,1,0,1
2006,Education,Anthropology,1,1,0
2006,Education,Anthropology,164,49,115
2006,Education,Anthropology,56,19,37
2005,Education,Anthropology,2,0,2
2005,Education,Anthropology,1,0,1
2005,Education,Anthropology,143,49,94
2005,Education,Anthropology,61,23,38
2004,Education,Anthropology,129,41,88
2004,Education,Anthropology,1,1,0
2004,Education,Anthropology,2,0,2
2004,Education,Anthropology,1,1,0
2004,Education,Anthropology,58,17,41
2018,Education,Applied Mathematics,13,8,5
2017,Education,Applied Mathematics,17,13,4
2017,Education,Applied Mathematics,37,24,13
2016,Education,Applied Mathematics,10,7,3
2016,Education,Applied Mathematics,36,21,15
2015,Education,Applied Mathematics,9,6,3
2015,Education,Applied Mathematics,27,14,13
2014,Education,Applied Mathematics,9,5,4
2014,Education,Applied Mathematics,25,12,13
2013,Education,Applied Mathematics,14,7,7
2013,Education,Applied Mathematics,1,1,0
2013,Education,Applied Mathematics,24,12,12
2012,Education,Applied Mathematics,20,7,13
2012,Education,Applied Mathematics,11,8,3
2011,Education,Applied Mathematics,15,8,7
2011,Education,Applied Mathematics,13,11,2
2010,Education,Applied Mathematics,9,5,4
2010,Education,Applied Mathematics,15,9,6
2009,Education,Applied Mathematics,10,5,5
2009,Education,Applied Mathematics,13,4,9
2008,Education,Applied Mathematics,12,9,3
2008,Education,Applied Mathematics,16,5,11
2007,Education,Applied Mathematics,13,11,2
2007,Education,Applied Mathematics,12,5,7
2006,Education,Applied Mathematics,10,9,1
2006,Education,Applied Mathematics,17,7,10
2005,Education,Applied Mathematics,7,4,3
2005,Education,Applied Mathematics,28,11,17
2004,Education,Applied Mathematics,12,10,2
2004,Education,Applied Mathematics,21,7,14
2004,Business,Finance,19,15,4
2010,LAS,Finance,2,2,0
2009,LAS,Finance,4,3,1
2008,LAS,Finance,3,3,0
2008,LAS,Finance,2,2,0
2007,LAS,Finance,2,1,1
2007,LAS,Finance,91,59,32
2006,LAS,Finance,4,2,2
2006,LAS,Finance,184,129,55
2005,LAS,Finance,17,10,7
2005,LAS,Finance,145,107,38
2004,LAS,Finance,217,158,59
2018,Engineering,Financial Engineering,126,88,38
2018,Engineering,Financial Engineering,1,1,0
2017,Engineering,Financial Engineering,128,88,40
2016,Engineering,Financial Engineering,121,84,37
2015,Engineering,Financial Engineering,122,91,31
2014,Engineering,Financial Engineering,109,76,33
2013,Engineering,Financial Engineering,98,62,36
2012,Engineering,Financial Engineering,100,67,33
2011,Engineering,Financial Engineering,69,52,17
2010,Engineering,Financial Engineering,26,21,5
1980,ACES,Food Science & Human Nutrition,28,18,10
1981,ACES,Food Science & Human Nutrition,18,13,5
1982,ACES,Food Science & Human Nutrition,10,4,6
1983,ACES,Food Science & Human Nutrition,13,9,4
1984,ACES,Food Science & Human Nutrition,22,9,13
1985,ACES,Food Science & Human Nutrition,20,8,12
1986,ACES,Food Science & Human Nutrition,15,10,5
1987,ACES,Food Science & Human Nutrition,18,9,9
1988,ACES,Food Science & Human Nutrition,12,6,6
1989,ACES,Food Science & Human Nutrition,9,4,5
1990,ACES,Food Science & Human Nutrition,8,5,3
1991,ACES,Food Science & Human Nutrition,9,4,5
1992,ACES,Food Science & Human Nutrition,8,3,5
1993,ACES,Food Science & Human Nutrition,9,4,5
1994,ACES,Food Science & Human Nutrition,9,3,6
1995,ACES,Food Science & Human Nutrition,10,6,4
1996,ACES,Food Science & Human Nutrition,14,8,6
1997,ACES,Food Science & Human Nutrition,8,5,3
1980,ACES,Food Science & Human Nutrition,53,18,35
1980,ACES,Food Science & Human Nutrition,63,41,22
1981,ACES,Food Science & Human Nutrition,54,16,38
1981,ACES,Food Science & Human Nutrition,66,42,24
1982,ACES,Food Science & Human Nutrition,47,14,33
1982,ACES,Food Science & Human Nutrition,68,43,25
1983,ACES,Food Science & Human Nutrition,45,17,28
1983,ACES,Food Science & Human Nutrition,74,51,23
1984,ACES,Food Science & Human Nutrition,33,11,22
1984,ACES,Food Science & Human Nutrition,69,47,22
1985,ACES,Food Science & Human Nutrition,32,5,27
1985,ACES,Food Science & Human Nutrition,62,41,21
1986,ACES,Food Science & Human Nutrition,49,12,37
1986,ACES,Food Science & Human Nutrition,58,39,19
1987,ACES,Food Science & Human Nutrition,51,14,37
1987,ACES,Food Science & Human Nutrition,67,47,20
1988,ACES,Food Science & Human Nutrition,45,11,34
1988,ACES,Food Science & Human Nutrition,64,37,27
1989,ACES,Food Science & Human Nutrition,46,15,31
1989,ACES,Food Science & Human Nutrition,56,35,21
1990,ACES,Food Science & Human Nutrition,40,15,25
1990,ACES,Food Science & Human Nutrition,62,41,21
1991,ACES,Food Science & Human Nutrition,45,15,30
1991,ACES,Food Science & Human Nutrition,60,34,26
1992,ACES,Food Science & Human Nutrition,64,29,35
1992,ACES,Food Science & Human Nutrition,74,36,38
1993,ACES,Food Science & Human Nutrition,53,19,34
1993,ACES,Food Science & Human Nutrition,81,36,45
1994,ACES,Food Science & Human Nutrition,55,20,35
1994,ACES,Food Science & Human Nutrition,76,30,46
1995,ACES,Food Science & Human Nutrition,58,22,36
1995,ACES,Food Science & Human Nutrition,56,24,32
1996,ACES,Food Science & Human Nutrition,52,17,35
1996,ACES,Food Science & Human Nutrition,50,23,27
1997,ACES,Food Science & Human Nutrition,31,10,21
1997,ACES,Food Science & Human Nutrition,41,18,23
1998,ACES,Food Science & Human Nutrition,8,1,7
1998,ACES,Food Science & Human Nutrition,35,20,15
1999,ACES,Food Science & Human Nutrition,4,1,3
1999,ACES,Food Science & Human Nutrition,22,12,10
2000,ACES,Food Science & Human Nutrition,10,6,4
2001,ACES,Food Science & Human Nutrition,7,3,4
2002,ACES,Food Science & Human Nutrition,4,3,1
1998,ACES,Food Science & Human Nutrition,8,2,6
1999,ACES,Food Science & Human Nutrition,23,9,14
2000,ACES,Food Science & Human Nutrition,45,16,29
2001,ACES,Food Science & Human Nutrition,55,15,40
2002,ACES,Food Science & Human Nutrition,56,14,42
2003,ACES,Food Science & Human Nutrition,57,18,39
1984,ACES,Food Science & Human Nutrition,35,1,34
1985,ACES,Food Science & Human Nutrition,29,3,26
1986,ACES,Food Science & Human Nutrition,32,3,29
1987,ACES,Food Science & Human Nutrition,34,4,30
1988,ACES,Food Science & Human Nutrition,56,4,52
1989,ACES,Food Science & Human Nutrition,58,8,50
1990,ACES,Food Science & Human Nutrition,39,6,33
1991,ACES,Food Science & Human Nutrition,31,5,26
1992,ACES,Food Science & Human Nutrition,21,2,19
1993,ACES,Food Science & Human Nutrition,29,2,27
1994,ACES,Food Science & Human Nutrition,41,8,33
1995,ACES,Food Science & Human Nutrition,26,6,20
1996,ACES,Food Science & Human Nutrition,27,4,23
1997,ACES,Food Science & Human Nutrition,17,2,15
1998,ACES,Food Science & Human Nutrition,8,1,7
1999,ACES,Food Science & Human Nutrition,2,1,1
1980,ACES,Food Science & Human Nutrition,15,2,13
1980,ACES,Food Science & Human Nutrition,24,3,21
1981,ACES,Food Science & Human Nutrition,17,1,16
1981,ACES,Food Science & Human Nutrition,21,5,16
1982,ACES,Food Science & Human Nutrition,34,4,30
1982,ACES,Food Science & Human Nutrition,17,7,10
1983,ACES,Food Science & Human Nutrition,47,3,44
1983,ACES,Food Science & Human Nutrition,18,4,14
1984,ACES,Food Science & Human Nutrition,37,2,35
1984,ACES,Food Science & Human Nutrition,24,3,21
1985,ACES,Food Science & Human Nutrition,36,4,32
1985,ACES,Food Science & Human Nutrition,20,2,18
1986,ACES,Food Science & Human Nutrition,41,4,37
1986,ACES,Food Science & Human Nutrition,23,1,22
1987,ACES,Food Science & Human Nutrition,30,2,28
1987,ACES,Food Science & Human Nutrition,22,1,21
1988,ACES,Food Science & Human Nutrition,25,1,24
1988,ACES,Food Science & Human Nutrition,20,1,19
1989,ACES,Food Science & Human Nutrition,27,2,25
1989,ACES,Food Science & Human Nutrition,19,2,17
1990,ACES,Food Science & Human Nutrition,31,1,30
1990,ACES,Food Science & Human Nutrition,13,1,12
1991,ACES,Food Science & Human Nutrition,42,5,37
1991,ACES,Food Science & Human Nutrition,17,4,13
1992,ACES,Food Science & Human Nutrition,42,4,38
1992,ACES,Food Science & Human Nutrition,19,4,15
1993,ACES,Food Science & Human Nutrition,46,4,42
1993,ACES,Food Science & Human Nutrition,17,3,14
1994,ACES,Food Science & Human Nutrition,48,5,43
1994,ACES,Food Science & Human Nutrition,16,3,13
1995,ACES,Food Science & Human Nutrition,14,4,10
1996,ACES,Food Science & Human Nutrition,11,4,7
1997,ACES,Food Science & Human Nutrition,5,1,4
1997,ACES,Food Science & Human Nutrition,8,3,5
1998,ACES,Food Science & Human Nutrition,6,1,5
1999,ACES,Food Science & Human Nutrition,2,1,1
1997,ACES,Food Science & Human Nutrition,55,2,53
1998,ACES,Food Science & Human Nutrition,108,2,106
1999,ACES,Food Science & Human Nutrition,105,3,102
2000,ACES,Food Science & Human Nutrition,101,4,97
2001,ACES,Food Science & Human Nutrition,82,5,77
2002,ACES,Food Science & Human Nutrition,96,3,93
2003,ACES,Food Science & Human Nutrition,92,6,86
1997,ACES,Food Science & Human Nutrition,22,7,15
1998,ACES,Food Science & Human Nutrition,41,18,23
1999,ACES,Food Science & Human Nutrition,46,22,24
2000,ACES,Food Science & Human Nutrition,45,13,32
2001,ACES,Food Science & Human Nutrition,40,12,28
2002,ACES,Food Science & Human Nutrition,38,12,26
2003,ACES,Food Science & Human Nutrition,49,16,33
1997,ACES,Food Science & Human Nutrition,36,21,15
1998,ACES,Food Science & Human Nutrition,60,30,30
1999,ACES,Food Science & Human Nutrition,74,29,45
2000,ACES,Food Science & Human Nutrition,80,31,49
2001,ACES,Food Science & Human Nutrition,92,37,55
2002,ACES,Food Science & Human Nutrition,102,44,58
2003,ACES,Food Science & Human Nutrition,97,41,56
1997,ACES,Food Science & Human Nutrition,32,4,28
1998,ACES,Food Science & Human Nutrition,35,6,29
1999,ACES,Food Science & Human Nutrition,44,9,35
2000,ACES,Food Science & Human Nutrition,40,7,33
2001,ACES,Food Science & Human Nutrition,55,10,45
2002,ACES,Food Science & Human Nutrition,50,10,40
2003,ACES,Food Science & Human Nutrition,59,15,44
1997,ACES,Food Science & Human Nutrition,23,12,11
1998,ACES,Food Science & Human Nutrition,34,15,19
1999,ACES,Food Science & Human Nutrition,32,10,22
2000,ACES,Food Science & Human Nutrition,46,18,28
2001,ACES,Food Science & Human Nutrition,31,11,20
2002,ACES,Food Science & Human Nutrition,29,8,21
2003,ACES,Food Science & Human Nutrition,35,12,23
2018,ACES,Food Science & Human Nutrition,135,38,97
2018,ACES,Food Science & Human Nutrition,68,16,52
2018,ACES,Food Science & Human Nutrition,76,4,72
2018,ACES,Food Science & Human Nutrition,54,25,29
2018,ACES,Food Science & Human Nutrition,55,15,40
2018,ACES,Food Science & Human Nutrition,20,12,8
2018,ACES,Food Science & Human Nutrition,15,3,12
2018,ACES,Food Science & Human Nutrition,12,2,10
2018,ACES,Food Science & Human Nutrition,31,13,18
2018,ACES,Food Science & Human Nutrition,14,2,12
2017,ACES,Food Science & Human Nutrition,164,43,121
2017,ACES,Food Science & Human Nutrition,92,15,77
2017,ACES,Food Science & Human Nutrition,81,5,76
2017,ACES,Food Science & Human Nutrition,46,22,24
2017,ACES,Food Science & Human Nutrition,57,21,36
2017,ACES,Food Science & Human Nutrition,25,9,16
2017,ACES,Food Science & Human Nutrition,12,2,10
2017,ACES,Food Science & Human Nutrition,18,4,14
2017,ACES,Food Science & Human Nutrition,28,12,16
2017,ACES,Food Science & Human Nutrition,13,2,11
2016,ACES,Food Science & Human Nutrition,142,36,106
2016,ACES,Food Science & Human Nutrition,105,15,90
2016,ACES,Food Science & Human Nutrition,79,4,75
2016,ACES,Food Science & Human Nutrition,49,16,33
2016,ACES,Food Science & Human Nutrition,1,0,1
2016,ACES,Food Science & Human Nutrition,24,9,15
2016,ACES,Food Science & Human Nutrition,13,3,10
2016,ACES,Food Science & Human Nutrition,14,4,10
2016,ACES,Food Science & Human Nutrition,32,12,20
2016,ACES,Food Science & Human Nutrition,10,3,7
2015,ACES,Food Science & Human Nutrition,2,0,2
2015,ACES,Food Science & Human Nutrition,9,1,8
2015,ACES,Food Science & Human Nutrition,11,5,6
2015,ACES,Food Science & Human Nutrition,107,19,88
2015,ACES,Food Science & Human Nutrition,16,4,12
2015,ACES,Food Science & Human Nutrition,56,19,37
2015,ACES,Food Science & Human Nutrition,80,3,77
2015,ACES,Food Science & Human Nutrition,26,11,15
2015,ACES,Food Science & Human Nutrition,37,15,22
2015,ACES,Food Science & Human Nutrition,149,42,107
2014,ACES,Food Science & Human Nutrition,3,1,2
2014,ACES,Food Science & Human Nutrition,1,1,0
2014,ACES,Food Science & Human Nutrition,1,0,1
2014,ACES,Food Science & Human Nutrition,6,1,5
2014,ACES,Food Science & Human Nutrition,9,3,6
2014,ACES,Food Science & Human Nutrition,11,5,6
2014,ACES,Food Science & Human Nutrition,89,5,84
2014,ACES,Food Science & Human Nutrition,71,23,48
2014,ACES,Food Science & Human Nutrition,19,4,15
2014,ACES,Food Science & Human Nutrition,98,20,78
2014,ACES,Food Science & Human Nutrition,25,7,18
2014,ACES,Food Science & Human Nutrition,33,13,20
2014,ACES,Food Science & Human Nutrition,151,49,102
2013,ACES,Food Science & Human Nutrition,7,3,4
2013,ACES,Food Science & Human Nutrition,1,0,1
2013,ACES,Food Science & Human Nutrition,10,0,10
2013,ACES,Food Science & Human Nutrition,18,5,13
2013,ACES,Food Science & Human Nutrition,25,11,14
2013,ACES,Food Science & Human Nutrition,10,2,8
2013,ACES,Food Science & Human Nutrition,28,7,21
2013,ACES,Food Science & Human Nutrition,12,3,9
2013,ACES,Food Science & Human Nutrition,88,4,84
2013,ACES,Food Science & Human Nutrition,71,28,43
2013,ACES,Food Science & Human Nutrition,120,17,103
2013,ACES,Food Science & Human Nutrition,139,43,96
2012,ACES,Food Science & Human Nutrition,14,6,8
2012,ACES,Food Science & Human Nutrition,2,1,1
2012,ACES,Food Science & Human Nutrition,1,0,1
2012,ACES,Food Science & Human Nutrition,27,6,21
2012,ACES,Food Science & Human Nutrition,8,0,8
2012,ACES,Food Science & Human Nutrition,13,3,10
2012,ACES,Food Science & Human Nutrition,17,7,10
2012,ACES,Food Science & Human Nutrition,9,1,8
2012,ACES,Food Science & Human Nutrition,12,5,7
2012,ACES,Food Science & Human Nutrition,96,6,90
2012,ACES,Food Science & Human Nutrition,78,28,50
2012,ACES,Food Science & Human Nutrition,129,42,87
2012,ACES,Food Science & Human Nutrition,112,16,96
2011,ACES,Food Science & Human Nutrition,3,1,2
2011,ACES,Food Science & Human Nutrition,1,0,1
2011,ACES,Food Science & Human Nutrition,10,2,8
2011,ACES,Food Science & Human Nutrition,20,6,14
2011,ACES,Food Science & Human Nutrition,11,3,8
2011,ACES,Food Science & Human Nutrition,5,1,4
2011,ACES,Food Science & Human Nutrition,31,13,18
2011,ACES,Food Science & Human Nutrition,87,2,85
2011,ACES,Food Science & Human Nutrition,23,9,14
2011,ACES,Food Science & Human Nutrition,6,0,6
2011,ACES,Food Science & Human Nutrition,70,21,49
2011,ACES,Food Science & Human Nutrition,107,29,78
2011,ACES,Food Science & Human Nutrition,119,20,99
2010,ACES,Food Science & Human Nutrition,10,0,10
2010,ACES,Food Science & Human Nutrition,5,3,2
2010,ACES,Food Science & Human Nutrition,22,8,14
2010,ACES,Food Science & Human Nutrition,5,1,4
2010,ACES,Food Science & Human Nutrition,2,1,1
2010,ACES,Food Science & Human Nutrition,26,12,14
2010,ACES,Food Science & Human Nutrition,65,1,64
2010,ACES,Food Science & Human Nutrition,16,7,9
2010,ACES,Food Science & Human Nutrition,7,2,5
2010,ACES,Food Science & Human Nutrition,63,16,47
2010,ACES,Food Science & Human Nutrition,107,29,78
2010,ACES,Food Science & Human Nutrition,111,16,95
2009,ACES,Food Science & Human Nutrition,2,2,0
2009,ACES,Food Science & Human Nutrition,26,13,13
2009,ACES,Food Science & Human Nutrition,80,3,77
2009,ACES,Food Science & Human Nutrition,99,15,84
2009,ACES,Food Science & Human Nutrition,78,19,59
2009,ACES,Food Science & Human Nutrition,94,28,66
2009,ACES,Food Science & Human Nutrition,25,9,16
2009,ACES,Food Science & Human Nutrition,39,8,31
2008,ACES,Food Science & Human Nutrition,24,7,17
2008,ACES,Food Science & Human Nutrition,1,0,1
2008,ACES,Food Science & Human Nutrition,89,23,66
2008,ACES,Food Science & Human Nutrition,69,1,68
2008,ACES,Food Science & Human Nutrition,77,17,60
2008,ACES,Food Science & Human Nutrition,77,27,50
2008,ACES,Food Science & Human Nutrition,32,6,26
2008,ACES,Food Science & Human Nutrition,28,12,16
2007,ACES,Food Science & Human Nutrition,91,23,68
2007,ACES,Food Science & Human Nutrition,88,4,84
2007,ACES,Food Science & Human Nutrition,33,12,21
2007,ACES,Food Science & Human Nutrition,81,25,56
2007,ACES,Food Science & Human Nutrition,61,21,40
2007,ACES,Food Science & Human Nutrition,25,4,21
2007,ACES,Food Science & Human Nutrition,34,14,20
2006,ACES,Food Science & Human Nutrition,34,13,21
2006,ACES,Food Science & Human Nutrition,96,4,92
2006,ACES,Food Science & Human Nutrition,98,24,74
2006,ACES,Food Science & Human Nutrition,88,34,54
2006,ACES,Food Science & Human Nutrition,53,17,36
2006,ACES,Food Science & Human Nutrition,20,4,16
2006,ACES,Food Science & Human Nutrition,25,10,15
2005,ACES,Food Science & Human Nutrition,37,20,17
2005,ACES,Food Science & Human Nutrition,90,20,70
2005,ACES,Food Science & Human Nutrition,107,1,106
2005,ACES,Food Science & Human Nutrition,106,36,70
2005,ACES,Food Science & Human Nutrition,54,22,32
2005,ACES,Food Science & Human Nutrition,19,2,17
2005,ACES,Food Science & Human Nutrition,27,8,19
2004,ACES,Food Science & Human Nutrition,48,14,34
2004,ACES,Food Science & Human Nutrition,40,14,26
2004,ACES,Food Science & Human Nutrition,75,16,59
2004,ACES,Food Science & Human Nutrition,99,3,96
2004,ACES,Food Science & Human Nutrition,95,34,61
2004,ACES,Food Science & Human Nutrition,28,6,22
2004,ACES,Food Science & Human Nutrition,28,8,20
1980,ACES,Forestry,103,80,23
1981,ACES,Forestry,96,73,23
1982,ACES,Forestry,25,19,6
1983,ACES,Forestry,9,6,3
1980,ACES,Forestry,21,15,6
1981,ACES,Forestry,23,18,5
1982,ACES,Forestry,59,45,14
1982,ACES,Forestry,16,12,4
1983,ACES,Forestry,59,44,15
1983,ACES,Forestry,18,15,3
1984,ACES,Forestry,56,38,18
1984,ACES,Forestry,18,12,6
1985,ACES,Forestry,57,41,16
1985,ACES,Forestry,21,15,6
1986,ACES,Forestry,50,38,12
1986,ACES,Forestry,14,9,5
1987,ACES,Forestry,52,44,8
1987,ACES,Forestry,14,10,4
1988,ACES,Forestry,44,36,8
1988,ACES,Forestry,12,9,3
1989,ACES,Forestry,47,36,11
1989,ACES,Forestry,23,16,7
1990,ACES,Forestry,48,34,14
1990,ACES,Forestry,20,15,5
1991,ACES,Forestry,78,53,25
1991,ACES,Forestry,25,15,10
1992,ACES,Forestry,101,64,37
1992,ACES,Forestry,29,19,10
1993,ACES,Forestry,128,81,47
1993,ACES,Forestry,41,21,20
1994,ACES,Forestry,161,79,82
1994,ACES,Forestry,43,20,23
1995,ACES,Forestry,171,96,75
1995,ACES,Forestry,47,24,23
1996,ACES,Forestry,149,78,71
1996,ACES,Forestry,28,11,17
1997,ACES,Forestry,94,49,45
1997,ACES,Forestry,13,4,9
1998,ACES,Forestry,25,12,13
1999,ACES,Forestry,3,2,1
1997,ACES,Forestry,17,13,4
1998,ACES,Forestry,20,13,7
1999,ACES,Forestry,25,14,11
2000,ACES,Forestry,24,19,5
2001,ACES,Forestry,20,17,3
2002,ACES,Forestry,16,13,3
2003,ACES,Forestry,6,5,1
2005,ACES,Forestry,1,1,0
2004,ACES,Forestry,4,3,1
2004,ACES,Forestry,1,1,0
2018,LAS,French,4,2,2
2018,LAS,French,1,1,0
2018,LAS,French,8,3,5
2018,LAS,French,2,2,0
2018,LAS,French,5,1,4
2018,LAS,French,1,1,0
2018,LAS,French,14,5,9
2018,LAS,French,1,1,0
2017,LAS,French,7,2,5
2017,LAS,French,2,2,0
2017,LAS,French,7,3,4
2017,LAS,French,6,1,5
2017,LAS,French,1,1,0
2017,LAS,French,12,5,7
2017,LAS,French,1,0,1
2016,LAS,French,8,4,4
2016,LAS,French,2,1,1
2016,LAS,French,1,0,1
2016,LAS,French,5,1,4
2016,LAS,French,6,4,2
2016,LAS,French,3,0,3
2016,LAS,French,11,4,7
2016,LAS,French,1,0,1
2015,LAS,French,3,2,1
2015,LAS,French,1,0,1
2015,LAS,French,1,0,1
2015,LAS,French,1,0,1
2015,LAS,French,3,1,2
2015,LAS,French,1,0,1
2015,LAS,French,1,0,1
2015,LAS,French,2,1,1
2015,LAS,French,8,4,4
2015,LAS,French,10,3,7
2015,LAS,French,11,3,8
2014,LAS,French,1,0,1
2014,LAS,French,1,0,1
2014,LAS,French,4,1,3
2014,LAS,French,1,0,1
2014,LAS,French,1,0,1
2014,LAS,French,9,4,5
2014,LAS,French,4,1,3
2014,LAS,French,2,1,1
2014,LAS,French,6,3,3
2014,LAS,French,14,7,7
2013,LAS,French,2,1,1
2013,LAS,French,1,0,1
2013,LAS,French,3,0,3
2013,LAS,French,1,0,1
2013,LAS,French,1,1,0
2013,LAS,French,1,0,1
2013,LAS,French,8,4,4
2013,LAS,French,1,0,1
2013,LAS,French,19,6,13
2013,LAS,French,16,5,11
2012,LAS,French,3,1,2
2012,LAS,French,4,1,3
2012,LAS,French,1,0,1
2012,LAS,French,7,3,4
2012,LAS,French,2,0,2
2012,LAS,French,23,4,19
2012,LAS,French,8,3,5
2012,LAS,French,16,6,10
2011,LAS,French,5,3,2
2011,LAS,French,1,0,1
2011,LAS,French,32,6,26
2011,LAS,French,6,1,5
2011,LAS,French,20,8,12
2011,LAS,French,13,5,8
2010,LAS,French,1,0,1
2010,LAS,French,7,3,4
2010,LAS,French,1,0,1
2010,LAS,French,11,1,10
2010,LAS,French,1,0,1
2010,LAS,French,19,5,14
2010,LAS,French,20,6,14
2010,LAS,French,21,8,13
2009,LAS,French,9,2,7
2009,LAS,French,1,0,1
2009,LAS,French,14,3,11
2009,LAS,French,25,7,18
2009,LAS,French,12,5,7
2009,LAS,French,9,1,8
2009,LAS,French,16,5,11
2008,LAS,French,10,5,5
2008,LAS,French,1,1,0
2008,LAS,French,1,0,1
2008,LAS,French,36,8,28
2008,LAS,French,13,2,11
2008,LAS,French,5,0,5
2008,LAS,French,13,5,8
2008,LAS,French,17,5,12
2007,LAS,French,8,4,4
2007,LAS,French,1,1,0
2007,LAS,French,5,1,4
2007,LAS,French,49,6,43
2007,LAS,French,5,4,1
2007,LAS,French,11,5,6
2007,LAS,French,17,5,12
2006,LAS,French,1,1,0
2006,LAS,French,6,2,4
2006,LAS,French,6,1,5
2006,LAS,French,5,3,2
2006,LAS,French,63,11,52
2006,LAS,French,14,4,10
2006,LAS,French,16,5,11
2005,LAS,French,7,3,4
2005,LAS,French,3,0,3
2005,LAS,French,5,3,2
2005,LAS,French,57,14,43
2005,LAS,French,17,6,11
2005,LAS,French,13,3,10
2004,LAS,French,54,13,41
2004,LAS,French,5,1,4
2004,LAS,French,2,0,2
2004,LAS,French,16,4,12
2004,LAS,French,4,2,2
2004,LAS,French,14,2,12
1980,LAS,French,40,7,33
1981,LAS,French,33,6,27
1982,LAS,French,33,10,23
1983,LAS,French,31,9,22
1984,LAS,French,40,9,31
1985,LAS,French,45,8,37
1986,LAS,French,44,12,32
1987,LAS,French,46,12,34
1988,LAS,French,48,15,33
1989,LAS,French,51,19,32
1990,LAS,French,55,19,36
1991,LAS,French,65,19,46
1992,LAS,French,59,22,37
1993,LAS,French,59,15,44
1994,LAS,French,60,19,41
1995,LAS,French,54,15,39
1996,LAS,French,45,14,31
1997,LAS,French,46,11,35
1998,LAS,French,38,13,25
1999,LAS,French,37,9,28
2000,LAS,French,34,4,30
2001,LAS,French,31,5,26
2002,LAS,French,30,6,24
2003,LAS,French,28,4,24
1980,ACES,GEN AGR,74,57,17
1981,ACES,GEN AGR,47,37,10
1982,ACES,GEN AGR,44,33,11
1983,ACES,GEN AGR,34,28,6
1984,ACES,GEN AGR,29,23,6
1985,ACES,GEN AGR,32,23,9
1986,ACES,GEN AGR,18,12,6
1987,ACES,GEN AGR,13,8,5
1988,ACES,GEN AGR,17,13,4
1989,ACES,GEN AGR,23,18,5
1990,ACES,GEN AGR,20,17,3
1991,ACES,GEN AGR,23,18,5
1992,ACES,GEN AGR,15,9,6
1993,ACES,GEN AGR,14,12,2
1994,ACES,GEN AGR,2,1,1
1980,LAS,GEN CURR,2408,1015,1393
1981,LAS,GEN CURR,2461,1103,1358
1982,LAS,GEN CURR,2182,960,1222
1983,LAS,GEN CURR,2074,841,1233
1984,LAS,GEN CURR,2230,916,1314
1985,LAS,GEN CURR,2284,921,1363
1986,LAS,GEN CURR,2269,956,1313
1987,LAS,GEN CURR,2146,932,1214
1988,LAS,GEN CURR,2182,1008,1174
1989,LAS,GEN CURR,2104,971,1133
1990,LAS,GEN CURR,2184,1089,1095
1991,LAS,GEN CURR,2171,1041,1130
1992,LAS,GEN CURR,2093,972,1121
1993,LAS,GEN CURR,2073,974,1099
1994,LAS,GEN CURR,2207,1002,1205
1995,LAS,GEN CURR,2446,1082,1364
1996,LAS,GEN CURR,2509,1172,1337
1997,LAS,GEN CURR,2372,1093,1279
1998,LAS,GEN CURR,2706,1255,1451
1999,LAS,GEN CURR,2838,1356,1482
2000,LAS,GEN CURR,2459,1233,1226
2001,LAS,GEN CURR,2198,994,1204
2002,LAS,GEN CURR,2075,964,1111
2003,LAS,GEN CURR,2090,1052,1038
1980,Engineering,GEN ENGR,558,445,113
1980,Engineering,GEN ENGR,34,20,14
1980,Engineering,GEN ENGR,19,13,6
1981,Engineering,GEN ENGR,528,410,118
1981,Engineering,GEN ENGR,26,12,14
1981,Engineering,GEN ENGR,20,13,7
1981,Engineering,GEN ENGR,12,11,1
1982,Engineering,GEN ENGR,499,363,136
1982,Engineering,GEN ENGR,14,8,6
1982,Engineering,GEN ENGR,20,13,7
1982,Engineering,GEN ENGR,19,16,3
1983,Engineering,GEN ENGR,426,294,132
1983,Engineering,GEN ENGR,7,6,1
1983,Engineering,GEN ENGR,17,9,8
1983,Engineering,GEN ENGR,20,15,5
1984,Engineering,GEN ENGR,392,273,119
1984,Engineering,GEN ENGR,8,7,1
1984,Engineering,GEN ENGR,10,7,3
1984,Engineering,GEN ENGR,22,18,4
1985,Engineering,GEN ENGR,414,285,129
1985,Engineering,GEN ENGR,12,9,3
1985,Engineering,GEN ENGR,7,3,4
1985,Engineering,GEN ENGR,18,16,2
1986,Engineering,GEN ENGR,466,318,148
1986,Engineering,GEN ENGR,12,10,2
1986,Engineering,GEN ENGR,5,3,2
1986,Engineering,GEN ENGR,21,16,5
1987,Engineering,GEN ENGR,508,369,139
1987,Engineering,GEN ENGR,12,7,5
1987,Engineering,GEN ENGR,7,5,2
1987,Engineering,GEN ENGR,26,20,6
1988,Engineering,GEN ENGR,524,400,124
1988,Engineering,GEN ENGR,13,11,2
1988,Engineering,GEN ENGR,17,13,4
1988,Engineering,GEN ENGR,34,29,5
1989,Engineering,GEN ENGR,555,429,126
1989,Engineering,GEN ENGR,16,13,3
1989,Engineering,GEN ENGR,24,15,9
1989,Engineering,GEN ENGR,31,26,5
1990,Engineering,GEN ENGR,580,464,116
1990,Engineering,GEN ENGR,7,4,3
1990,Engineering,GEN ENGR,19,12,7
1990,Engineering,GEN ENGR,31,26,5
1991,Engineering,GEN ENGR,584,457,127
1991,Engineering,GEN ENGR,5,4,1
1991,Engineering,GEN ENGR,21,13,8
1991,Engineering,GEN ENGR,34,27,7
1992,Engineering,GEN ENGR,548,424,124
1992,Engineering,GEN ENGR,5,4,1
1992,Engineering,GEN ENGR,24,16,8
1992,Engineering,GEN ENGR,37,28,9
1993,Engineering,GEN ENGR,509,393,116
1993,Engineering,GEN ENGR,3,2,1
1993,Engineering,GEN ENGR,21,16,5
1993,Engineering,GEN ENGR,42,36,6
1994,Engineering,GEN ENGR,530,411,119
1994,Engineering,GEN ENGR,16,11,5
1994,Engineering,GEN ENGR,45,37,8
1995,Engineering,GEN ENGR,512,396,116
1995,Engineering,GEN ENGR,13,11,2
1995,Engineering,GEN ENGR,31,25,6
1996,Engineering,GEN ENGR,482,359,123
1996,Engineering,GEN ENGR,18,14,4
1997,Engineering,GEN ENGR,419,290,129
1997,Engineering,GEN ENGR,13,12,1
1997,Engineering,GEN ENGR,18,16,2
1998,Engineering,GEN ENGR,414,286,128
1999,Engineering,GEN ENGR,403,283,120
1999,Engineering,GEN ENGR,5,2,3
1999,Engineering,GEN ENGR,19,17,2
2000,Engineering,GEN ENGR,440,316,124
2000,Engineering,GEN ENGR,4,2,2
2000,Engineering,GEN ENGR,5,2,3
2000,Engineering,GEN ENGR,30,25,5
2001,Engineering,GEN ENGR,470,358,112
2001,Engineering,GEN ENGR,4,2,2
2001,Engineering,GEN ENGR,31,27,4
2002,Engineering,GEN ENGR,490,372,118
2002,Engineering,GEN ENGR,5,2,3
2002,Engineering,GEN ENGR,43,40,3
2003,Engineering,GEN ENGR,548,422,126
2003,Engineering,GEN ENGR,3,2,1
2003,Engineering,GEN ENGR,5,2,3
2003,Engineering,GEN ENGR,45,42,3
2018,LAS,Gender and Women's Studies,20,0,20
2017,LAS,Gender and Women's Studies,13,2,11
2016,LAS,Gender and Women's Studies,15,2,13
2016,LAS,Gender and Women's Studies,1,1,0
2015,LAS,Gender and Women's Studies,13,2,11
2014,LAS,Gender and Women's Studies,2,0,2
2014,LAS,Gender and Women's Studies,9,3,6
2013,LAS,Gender and Women's Studies,2,0,2
2013,LAS,Gender and Women's Studies,17,2,15
2012,LAS,Gender and Women's Studies,1,0,1
2012,LAS,Gender and Women's Studies,10,3,7
2011,LAS,Gender and Women's Studies,16,3,13
2010,LAS,Gender and Women's Studies,16,0,16
2009,LAS,Gender and Women's Studies,8,1,7
2009,LAS,Gender and Women's Studies,1,0,1
2006,Fine and Applied Arts,General Curriculum,8,5,3
2005,Fine and Applied Arts,General Curriculum,176,67,109
2004,Fine and Applied Arts,General Curriculum,147,45,101
2018,LAS,General Curriculum,121,76,45
2017,LAS,General Curriculum,163,106,57
2016,LAS,General Curriculum,134,86,48
2015,LAS,General Curriculum,155,102,53
2014,LAS,General Curriculum,202,123,79
2013,LAS,General Curriculum,163,95,68
2012,LAS,General Curriculum,41,25,16
2011,LAS,General Curriculum,24,12,12
2010,LAS,General Curriculum,87,29,58
2009,LAS,General Curriculum,227,94,133
2008,LAS,General Curriculum,1387,676,711
2007,LAS,General Curriculum,3379,1569,1809
2006,LAS,General Curriculum,3468,1597,1870
2005,LAS,General Curriculum,3775,1700,2070
2004,LAS,General Curriculum,3539,1549,1985
2012,Media,General Curriculum,1,0,1
2011,Media,General Curriculum,3,2,1
2010,Media,General Curriculum,31,10,21
2009,Media,General Curriculum,40,12,28
2008,Media,General Curriculum,45,12,33
2007,Media,General Curriculum,133,31,102
2006,Media,General Curriculum,156,45,111
2017,Engineering,General Engineering,3,3,0
2016,Engineering,General Engineering,219,169,50
2015,Engineering,General Engineering,230,172,58
2014,Engineering,General Engineering,271,211,60
2013,Engineering,General Engineering,320,248,72
2012,Engineering,General Engineering,368,270,98
2011,Engineering,General Engineering,384,307,77
2010,Engineering,General Engineering,426,326,99
2009,Engineering,General Engineering,454,349,104
2008,Engineering,General Engineering,2,2,0
2008,Engineering,General Engineering,540,409,131
2007,Engineering,General Engineering,8,7,1
2007,Engineering,General Engineering,587,470,116
2006,Engineering,General Engineering,19,17,2
2006,Engineering,General Engineering,561,452,109
2005,Engineering,General Engineering,23,20,3
2005,Engineering,General Engineering,601,489,112
2004,Engineering,General Engineering,581,464,117
2004,Engineering,General Engineering,26,22,4
2004,Engineering,General Engineering,1,1,0
1980,LAS,Genetics,6,3,3
1981,LAS,Genetics,5,2,3
1982,LAS,Genetics,5,2,3
1983,LAS,Genetics,6,3,3
1984,LAS,Genetics,4,2,2
1985,LAS,Genetics,3,2,1
2018,LAS,Geography,1,0,1
2018,LAS,Geography,4,2,2
2018,LAS,Geography,15,12,3
2018,LAS,Geography,33,18,15
2017,LAS,Geography,3,3,0
2017,LAS,Geography,17,11,6
2017,LAS,Geography,32,18,14
2016,LAS,Geography,1,1,0
2016,LAS,Geography,2,1,1
2016,LAS,Geography,3,2,1
2016,LAS,Geography,11,7,4
2016,LAS,Geography,33,19,14
2015,LAS,Geography,2,1,1
2015,LAS,Geography,1,1,0
2015,LAS,Geography,1,0,1
2015,LAS,Geography,3,1,2
2015,LAS,Geography,32,20,12
2014,LAS,Geography,2,2,0
2014,LAS,Geography,1,1,0
2014,LAS,Geography,1,0,1
2014,LAS,Geography,4,1,3
2014,LAS,Geography,4,2,2
2014,LAS,Geography,27,17,10
2013,LAS,Geography,5,5,0
2013,LAS,Geography,4,1,3
2013,LAS,Geography,3,2,1
2013,LAS,Geography,30,20,10
2012,LAS,Geography,1,1,0
2012,LAS,Geography,1,1,0
2012,LAS,Geography,1,0,1
2012,LAS,Geography,5,4,1
2012,LAS,Geography,1,1,0
2012,LAS,Geography,5,4,1
2012,LAS,Geography,2,2,0
2012,LAS,Geography,30,19,11
2012,LAS,Geography,12,10,2
2011,LAS,Geography,3,2,1
2011,LAS,Geography,2,1,1
2011,LAS,Geography,2,1,1
2011,LAS,Geography,5,4,1
2011,LAS,Geography,2,1,1
2011,LAS,Geography,1,0,1
2011,LAS,Geography,15,14,1
2011,LAS,Geography,33,21,12
2010,LAS,Geography,1,1,0
2010,LAS,Geography,1,1,0
2010,LAS,Geography,2,1,1
2010,LAS,Geography,1,1,0
2010,LAS,Geography,2,1,1
2010,LAS,Geography,2,1,1
2010,LAS,Geography,6,3,3
2010,LAS,Geography,4,1,3
2010,LAS,Geography,14,12,2
2010,LAS,Geography,37,24,13
2009,LAS,Geography,5,2,3
2009,LAS,Geography,1,1,0
2009,LAS,Geography,1,1,0
2009,LAS,Geography,22,15,6
2009,LAS,Geography,4,2,2
2009,LAS,Geography,7,5,2
2009,LAS,Geography,29,18,11
2008,LAS,Geography,1,1,0
2008,LAS,Geography,5,4,1
2008,LAS,Geography,11,7,4
2008,LAS,Geography,4,3,1
2008,LAS,Geography,33,24,8
2008,LAS,Geography,33,20,13
2007,LAS,Geography,4,4,0
2007,LAS,Geography,7,5,2
2007,LAS,Geography,1,1,0
2007,LAS,Geography,8,6,2
2007,LAS,Geography,45,31,14
2007,LAS,Geography,5,1,4
2007,LAS,Geography,26,14,12
2006,LAS,Geography,3,3,0
2006,LAS,Geography,1,0,1
2006,LAS,Geography,3,3,0
2006,LAS,Geography,7,4,3
2006,LAS,Geography,5,1,4
2006,LAS,Geography,39,29,10
2006,LAS,Geography,25,12,13
2005,LAS,Geography,1,1,0
2005,LAS,Geography,2,2,0
2005,LAS,Geography,1,1,0
2005,LAS,Geography,3,1,2
2005,LAS,Geography,3,3,0
2005,LAS,Geography,11,4,7
2005,LAS,Geography,41,34,7
2005,LAS,Geography,20,11,9
2004,LAS,Geography,35,29,6
2004,LAS,Geography,4,2,2
2004,LAS,Geography,14,5,9
2004,LAS,Geography,1,0,1
2004,LAS,Geography,3,3,0
2004,LAS,Geography,18,9,9
1980,LAS,Geography,43,30,13
1981,LAS,Geography,43,30,13
1982,LAS,Geography,36,28,8
1983,LAS,Geography,34,25,9
1984,LAS,Geography,35,21,14
1985,LAS,Geography,45,29,16
1986,LAS,Geography,40,29,11
1987,LAS,Geography,42,28,14
1988,LAS,Geography,34,22,12
1989,LAS,Geography,39,27,12
1990,LAS,Geography,39,21,18
1991,LAS,Geography,49,29,20
1992,LAS,Geography,49,28,21
1993,LAS,Geography,38,27,11
1994,LAS,Geography,45,32,13
1995,LAS,Geography,42,27,15
1996,LAS,Geography,43,27,16
1997,LAS,Geography,38,22,16
1998,LAS,Geography,28,15,13
1999,LAS,Geography,34,20,14
2000,LAS,Geography,33,20,13
2001,LAS,Geography,33,16,17
2002,LAS,Geography,30,13,17
2003,LAS,Geography,40,20,20
2018,LAS,Geography & Geographic Info Sc,23,18,5
2018,LAS,Geography & Geographic Info Sc,1,0,1
2018,LAS,Geography & Geographic Info Sc,11,9,2
2018,LAS,Geography & Geographic Info Sc,3,3,0
2017,LAS,Geography & Geographic Info Sc,25,20,5
2017,LAS,Geography & Geographic Info Sc,11,7,4
2017,LAS,Geography & Geographic Info Sc,2,2,0
2016,LAS,Geography & Geographic Info Sc,26,18,8
2016,LAS,Geography & Geographic Info Sc,1,1,0
2016,LAS,Geography & Geographic Info Sc,9,6,3
2015,LAS,Geography & Geographic Info Sc,2,2,0
2015,LAS,Geography & Geographic Info Sc,1,0,1
2015,LAS,Geography & Geographic Info Sc,12,8,4
2015,LAS,Geography & Geographic Info Sc,22,17,5
2014,LAS,Geography & Geographic Info Sc,2,2,0
2014,LAS,Geography & Geographic Info Sc,10,9,1
2014,LAS,Geography & Geographic Info Sc,1,1,0
2014,LAS,Geography & Geographic Info Sc,16,13,3
2013,LAS,Geography & Geographic Info Sc,1,1,0
2013,LAS,Geography & Geographic Info Sc,5,5,0
2013,LAS,Geography & Geographic Info Sc,12,12,0
2018,LAS,Geology,33,20,13
2018,LAS,Geology,7,6,1
2018,LAS,Geology,4,1,3
2018,LAS,Geology,8,7,1
2018,LAS,Geology,2,1,1
2018,LAS,Geology,8,4,4
2018,LAS,Geology,4,0,4
2018,LAS,Geology,31,16,15
2017,LAS,Geology,37,24,13
2017,LAS,Geology,5,3,2
2017,LAS,Geology,2,0,2
2017,LAS,Geology,9,7,2
2017,LAS,Geology,5,3,2
2017,LAS,Geology,3,3,0
2017,LAS,Geology,1,1,0
2017,LAS,Geology,4,2,2
2017,LAS,Geology,35,22,13
2016,LAS,Geology,36,24,12
2016,LAS,Geology,6,4,2
2016,LAS,Geology,18,16,2
2016,LAS,Geology,3,3,0
2016,LAS,Geology,1,1,0
2016,LAS,Geology,4,4,0
2016,LAS,Geology,1,0,1
2016,LAS,Geology,4,4,0
2016,LAS,Geology,30,20,10
2015,LAS,Geology,3,3,0
2015,LAS,Geology,2,0,2
2015,LAS,Geology,1,0,1
2015,LAS,Geology,4,2,2
2015,LAS,Geology,6,3,3
2015,LAS,Geology,23,21,2
2015,LAS,Geology,37,30,7
2015,LAS,Geology,11,10,1
2015,LAS,Geology,25,16,9
2014,LAS,Geology,4,2,2
2014,LAS,Geology,6,3,3
2014,LAS,Geology,3,2,1
2014,LAS,Geology,3,1,2
2014,LAS,Geology,28,22,6
2014,LAS,Geology,33,26,7
2014,LAS,Geology,16,13,3
2014,LAS,Geology,21,11,10
2013,LAS,Geology,6,4,2
2013,LAS,Geology,3,3,0
2013,LAS,Geology,13,8,5
2013,LAS,Geology,20,12,8
2013,LAS,Geology,27,20,7
2013,LAS,Geology,26,18,8
2013,LAS,Geology,5,3,2
2012,LAS,Geology,1,0,1
2012,LAS,Geology,2,2,0
2012,LAS,Geology,19,10,9
2012,LAS,Geology,15,8,7
2012,LAS,Geology,15,8,7
2012,LAS,Geology,3,3,0
2012,LAS,Geology,2,1,1
2012,LAS,Geology,16,11,5
2011,LAS,Geology,1,1,0
2011,LAS,Geology,3,2,1
2011,LAS,Geology,4,4,0
2011,LAS,Geology,17,11,6
2011,LAS,Geology,1,0,1
2011,LAS,Geology,10,3,7
2011,LAS,Geology,15,8,7
2011,LAS,Geology,11,8,3
2011,LAS,Geology,3,1,2
2010,LAS,Geology,5,4,1
2010,LAS,Geology,1,1,0
2010,LAS,Geology,4,3,1
2010,LAS,Geology,11,9,2
2010,LAS,Geology,1,0,1
2010,LAS,Geology,1,0,1
2010,LAS,Geology,14,7,7
2010,LAS,Geology,17,11,6
2010,LAS,Geology,19,13,6
2010,LAS,Geology,5,3,2
2009,LAS,Geology,14,10,4
2009,LAS,Geology,2,1,1
2009,LAS,Geology,3,3,0
2009,LAS,Geology,3,1,2
2009,LAS,Geology,9,4,5
2009,LAS,Geology,2,1,1
2009,LAS,Geology,18,14,4
2009,LAS,Geology,15,6,9
2009,LAS,Geology,16,9,7
2008,LAS,Geology,5,3,2
2008,LAS,Geology,10,4,6
2008,LAS,Geology,17,11,6
2008,LAS,Geology,22,17,5
2008,LAS,Geology,18,9,9
2008,LAS,Geology,16,9,7
2007,LAS,Geology,4,2,2
2007,LAS,Geology,1,0,1
2007,LAS,Geology,7,5,2
2007,LAS,Geology,18,13,5
2007,LAS,Geology,29,19,10
2007,LAS,Geology,15,7,8
2007,LAS,Geology,17,12,5
2006,LAS,Geology,2,2,0
2006,LAS,Geology,7,6,1
2006,LAS,Geology,4,1,3
2006,LAS,Geology,2,0,2
2006,LAS,Geology,3,2,1
2006,LAS,Geology,42,28,14
2006,LAS,Geology,15,9,6
2006,LAS,Geology,19,13,6
2005,LAS,Geology,12,7,5
2005,LAS,Geology,5,1,4
2005,LAS,Geology,1,1,0
2005,LAS,Geology,1,0,1
2005,LAS,Geology,6,4,2
2005,LAS,Geology,32,23,9
2005,LAS,Geology,14,8,6
2005,LAS,Geology,22,15,7
2004,LAS,Geology,13,9,4
2004,LAS,Geology,1,0,1
2004,LAS,Geology,26,17,9
2004,LAS,Geology,1,1,0
2004,LAS,Geology,3,3,0
2004,LAS,Geology,11,3,8
2004,LAS,Geology,2,1,1
2004,LAS,Geology,21,15,6
1980,LAS,Geology,64,45,19
1980,LAS,Geology,51,34,17
1981,LAS,Geology,63,40,23
1981,LAS,Geology,51,36,15
1982,LAS,Geology,60,41,19
1982,LAS,Geology,54,39,15
1983,LAS,Geology,61,40,21
1983,LAS,Geology,45,33,12
1984,LAS,Geology,60,42,18
1984,LAS,Geology,33,26,7
1985,LAS,Geology,55,39,16
1985,LAS,Geology,23,19,4
1986,LAS,Geology,50,36,14
1986,LAS,Geology,28,23,5
1987,LAS,Geology,55,41,14
1987,LAS,Geology,15,10,5
1988,LAS,Geology,39,34,5
1988,LAS,Geology,7,6,1
1989,LAS,Geology,35,29,6
1989,LAS,Geology,8,6,2
1990,LAS,Geology,41,32,9
1990,LAS,Geology,7,5,2
1991,LAS,Geology,39,30,9
1991,LAS,Geology,11,7,4
1992,LAS,Geology,40,27,13
1992,LAS,Geology,19,12,7
1993,LAS,Geology,40,28,12
1993,LAS,Geology,20,14,6
1994,LAS,Geology,44,25,19
1994,LAS,Geology,23,16,7
1995,LAS,Geology,42,25,17
1995,LAS,Geology,24,14,10
1996,LAS,Geology,34,21,13
1996,LAS,Geology,26,16,10
1997,LAS,Geology,20,14,6
1997,LAS,Geology,31,18,13
1998,LAS,Geology,29,15,14
1998,LAS,Geology,20,16,4
1999,LAS,Geology,28,21,7
1999,LAS,Geology,27,13,14
2000,LAS,Geology,33,23,10
2000,LAS,Geology,21,11,10
2001,LAS,Geology,33,23,10
2001,LAS,Geology,13,10,3
2002,LAS,Geology,34,21,13
2002,LAS,Geology,11,6,5
2003,LAS,Geology,38,24,14
2003,LAS,Geology,8,4,4
2018,LAS,German,1,1,0
2018,LAS,German,2,0,2
2018,LAS,German,6,5,1
2017,LAS,German,3,1,2
2017,LAS,German,2,0,2
2017,LAS,German,7,5,2
2016,LAS,German,6,4,2
2016,LAS,German,2,0,2
2016,LAS,German,4,2,2
2015,LAS,German,2,1,1
2015,LAS,German,5,4,1
2015,LAS,German,6,3,3
2014,LAS,German,3,0,3
2014,LAS,German,2,1,1
2014,LAS,German,7,3,4
2013,LAS,German,7,3,4
2013,LAS,German,2,0,2
2013,LAS,German,9,3,6
2012,LAS,German,6,2,4
2012,LAS,German,2,1,1
2012,LAS,German,9,4,5
2011,LAS,German,6,2,4
2011,LAS,German,2,1,1
2011,LAS,German,8,4,4
2010,LAS,German,7,3,4
2010,LAS,German,3,0,3
2010,LAS,German,11,5,6
2009,LAS,German,6,2,4
2009,LAS,German,4,3,1
2009,LAS,German,12,5,7
2008,LAS,German,2,0,2
2008,LAS,German,11,5,6
2008,LAS,German,8,1,7
2007,LAS,German,1,0,1
2007,LAS,German,7,1,6
2007,LAS,German,13,6,7
2006,LAS,German,1,1,0
2006,LAS,German,11,2,9
2006,LAS,German,11,5,6
2005,LAS,German,7,4,3
2005,LAS,German,16,4,12
2004,LAS,German,12,5,7
2004,LAS,German,1,0,1
2004,LAS,German,6,3,3
1980,LAS,German,26,13,13
1981,LAS,German,22,11,11
1982,LAS,German,20,12,8
1983,LAS,German,22,14,8
1984,LAS,German,27,12,15
1985,LAS,German,30,16,14
1986,LAS,German,28,20,8
1987,LAS,German,31,18,13
1988,LAS,German,33,15,18
1989,LAS,German,36,16,20
1990,LAS,German,37,21,16
1991,LAS,German,34,16,18
1992,LAS,German,40,17,23
1993,LAS,German,31,13,18
1994,LAS,German,32,15,17
1995,LAS,German,37,15,22
1996,LAS,German,35,15,20
1997,LAS,German,26,9,17
1998,LAS,German,23,10,13
1999,LAS,German,24,11,13
2000,LAS,German,23,11,12
2001,LAS,German,21,12,9
2002,LAS,German,21,10,11
2003,LAS,German,19,7,12
2018,LAS,Germanic Lang & Lit,1,0,1
2018,LAS,Germanic Lang & Lit,1,0,1
2018,LAS,Germanic Lang & Lit,1,0,1
2018,LAS,Germanic Lang & Lit,1,0,1
2017,LAS,Germanic Lang & Lit,2,1,1
2017,LAS,Germanic Lang & Lit,1,0,1
2017,LAS,Germanic Lang & Lit,1,1,0
2017,LAS,Germanic Lang & Lit,1,0,1
2016,LAS,Germanic Lang & Lit,2,0,2
2016,LAS,Germanic Lang & Lit,1,1,0
2016,LAS,Germanic Lang & Lit,1,0,1
2015,LAS,Germanic Lang & Lit,3,1,2
2015,LAS,Germanic Lang & Lit,1,0,1
2015,LAS,Germanic Lang & Lit,1,1,0
2015,LAS,Germanic Lang & Lit,5,3,2
2014,LAS,Germanic Lang & Lit,3,2,1
2014,LAS,Germanic Lang & Lit,1,0,1
2014,LAS,Germanic Lang & Lit,1,1,0
2014,LAS,Germanic Lang & Lit,1,0,1
2014,LAS,Germanic Lang & Lit,1,1,0
2014,LAS,Germanic Lang & Lit,3,1,2
2013,LAS,Germanic Lang & Lit,4,2,2
2013,LAS,Germanic Lang & Lit,1,1,0
2013,LAS,Germanic Lang & Lit,1,0,1
2013,LAS,Germanic Lang & Lit,1,1,0
2013,LAS,Germanic Lang & Lit,1,1,0
2013,LAS,Germanic Lang & Lit,1,1,0
2013,LAS,Germanic Lang & Lit,1,0,1
2013,LAS,Germanic Lang & Lit,2,0,2
2013,LAS,Germanic Lang & Lit,1,1,0
2012,LAS,Germanic Lang & Lit,8,4,4
2012,LAS,Germanic Lang & Lit,2,1,1
2012,LAS,Germanic Lang & Lit,2,1,1
2012,LAS,Germanic Lang & Lit,2,1,1
2012,LAS,Germanic Lang & Lit,1,0,1
2012,LAS,Germanic Lang & Lit,1,0,1
2011,LAS,Germanic Lang & Lit,9,3,6
2011,LAS,Germanic Lang & Lit,1,0,1
2011,LAS,Germanic Lang & Lit,1,0,1
2011,LAS,Germanic Lang & Lit,1,0,1
2011,LAS,Germanic Lang & Lit,1,1,0
2011,LAS,Germanic Lang & Lit,1,0,1
2010,LAS,Germanic Lang & Lit,8,3,5
2010,LAS,Germanic Lang & Lit,1,1,0
2010,LAS,Germanic Lang & Lit,2,1,1
2010,LAS,Germanic Lang & Lit,2,0,2
2010,LAS,Germanic Lang & Lit,1,1,0
2010,LAS,Germanic Lang & Lit,1,1,0
2009,LAS,Germanic Lang & Lit,8,3,4
2009,LAS,Germanic Lang & Lit,4,0,4
2009,LAS,Germanic Lang & Lit,1,0,1
2009,LAS,Germanic Lang & Lit,3,0,3
2009,LAS,Germanic Lang & Lit,2,1,1
2009,LAS,Germanic Lang & Lit,1,1,0
2009,LAS,Germanic Lang & Lit,1,1,0
2009,LAS,Germanic Lang & Lit,9,5,4
2008,LAS,Germanic Lang & Lit,6,3,3
2008,LAS,Germanic Lang & Lit,7,2,5
2008,LAS,Germanic Lang & Lit,1,1,0
2008,LAS,Germanic Lang & Lit,4,1,3
2008,LAS,Germanic Lang & Lit,2,1,1
2008,LAS,Germanic Lang & Lit,14,7,7
2007,LAS,Germanic Lang & Lit,6,4,2
2007,LAS,Germanic Lang & Lit,2,2,0
2007,LAS,Germanic Lang & Lit,1,1,0
2007,LAS,Germanic Lang & Lit,21,6,14
2007,LAS,Germanic Lang & Lit,2,1,1
2006,LAS,Germanic Lang & Lit,5,5,0
2006,LAS,Germanic Lang & Lit,1,0,1
2006,LAS,Germanic Lang & Lit,3,2,1
2006,LAS,Germanic Lang & Lit,23,12,11
2005,LAS,Germanic Lang & Lit,17,10,7
2005,LAS,Germanic Lang & Lit,2,2,0
2005,LAS,Germanic Lang & Lit,1,0,1
2005,LAS,Germanic Lang & Lit,3,1,2
2004,LAS,Germanic Lang & Lit,10,6,4
2004,LAS,Germanic Lang & Lit,1,0,1
2004,LAS,Germanic Lang & Lit,1,0,1
2004,LAS,Germanic Lang & Lit,2,1,1
2004,LAS,Germanic Lang & Lit,2,0,2
2018,LAS,Germanic Studies,1,1,0
2018,LAS,Germanic Studies,1,1,0
2018,LAS,Germanic Studies,1,0,1
2018,LAS,Global Studies,153,44,109
2018,LAS,Global Studies,30,8,22
2017,LAS,Global Studies,165,45,120
2017,LAS,Global Studies,26,5,21
2016,LAS,Global Studies,157,42,115
2016,LAS,Global Studies,35,5,30
2015,LAS,Global Studies,36,6,30
2015,LAS,Global Studies,166,45,121
2014,LAS,Global Studies,47,10,37
2014,LAS,Global Studies,171,48,123
2013,LAS,Global Studies,40,9,31
2013,LAS,Global Studies,195,58,137
2012,LAS,Global Studies,29,8,21
2012,LAS,Global Studies,239,63,176
2011,LAS,Global Studies,14,5,9
2011,LAS,Global Studies,249,71,178
2010,LAS,Global Studies,3,1,2
2010,LAS,Global Studies,202,56,146
2009,LAS,Global Studies,93,25,68
1980,Fine and Applied Arts,Graphic Design,164,40,124
1981,Fine and Applied Arts,Graphic Design,165,37,128
1982,Fine and Applied Arts,Graphic Design,184,43,141
1983,Fine and Applied Arts,Graphic Design,170,50,120
1984,Fine and Applied Arts,Graphic Design,166,55,111
1985,Fine and Applied Arts,Graphic Design,144,53,91
1986,Fine and Applied Arts,Graphic Design,135,54,81
1987,Fine and Applied Arts,Graphic Design,120,46,74
1988,Fine and Applied Arts,Graphic Design,132,56,76
1989,Fine and Applied Arts,Graphic Design,131,57,74
1990,Fine and Applied Arts,Graphic Design,124,53,71
1991,Fine and Applied Arts,Graphic Design,120,57,63
1992,Fine and Applied Arts,Graphic Design,120,54,66
1993,Fine and Applied Arts,Graphic Design,115,50,65
1994,Fine and Applied Arts,Graphic Design,120,56,64
1995,Fine and Applied Arts,Graphic Design,109,39,70
1996,Fine and Applied Arts,Graphic Design,114,40,74
1997,Fine and Applied Arts,Graphic Design,127,47,80
1998,Fine and Applied Arts,Graphic Design,112,45,67
1999,Fine and Applied Arts,Graphic Design,109,41,68
2000,Fine and Applied Arts,Graphic Design,100,37,63
2001,Fine and Applied Arts,Graphic Design,92,32,60
2002,Fine and Applied Arts,Graphic Design,90,31,59
2003,Fine and Applied Arts,Graphic Design,81,22,59
2018,Fine and Applied Arts,Graphic Design,185,58,127
2017,Fine and Applied Arts,Graphic Design,167,41,126
2016,Fine and Applied Arts,Graphic Design,159,44,115
2015,Fine and Applied Arts,Graphic Design,94,19,75
2014,Fine and Applied Arts,Graphic Design,81,19,62
2013,Fine and Applied Arts,Graphic Design,77,25,52
2012,Fine and Applied Arts,Graphic Design,76,27,49
2011,Fine and Applied Arts,Graphic Design,70,27,43
2010,Fine and Applied Arts,Graphic Design,67,25,42
2009,Fine and Applied Arts,Graphic Design,64,23,41
2008,Fine and Applied Arts,Graphic Design,71,22,49
2007,Fine and Applied Arts,Graphic Design,78,26,52
2006,Fine and Applied Arts,Graphic Design,75,26,49
2005,Fine and Applied Arts,Graphic Design,75,21,54
2004,Fine and Applied Arts,Graphic Design,88,29,59
1981,ACES,H DVL-FAM,40,1,39
1982,ACES,H DVL-FAM,70,5,65
1983,ACES,H DVL-FAM,82,3,79
1984,ACES,H DVL-FAM,80,4,76
1985,ACES,H DVL-FAM,80,1,79
1986,ACES,H DVL-FAM,90,3,87
1987,ACES,H DVL-FAM,96,3,93
1988,ACES,H DVL-FAM,82,3,79
1989,ACES,H DVL-FAM,92,6,86
1990,ACES,H DVL-FAM,107,8,99
1991,ACES,H DVL-FAM,123,10,113
1992,ACES,H DVL-FAM,155,15,140
1993,ACES,H DVL-FAM,137,12,125
1994,ACES,H DVL-FAM,161,15,146
1995,ACES,H DVL-FAM,176,20,156
1996,ACES,H DVL-FAM,165,13,152
1997,ACES,H DVL-FAM,111,5,106
1998,ACES,H DVL-FAM,66,4,62
1999,ACES,H DVL-FAM,28,3,25
1997,ACES,HDFS-CH&AD DEV,49,3,46
1998,ACES,HDFS-CH&AD DEV,94,6,88
1999,ACES,HDFS-CH&AD DEV,113,3,110
2000,ACES,HDFS-CH&AD DEV,147,4,143
2001,ACES,HDFS-CH&AD DEV,140,4,136
2002,ACES,HDFS-CH&AD DEV,133,5,128
2003,ACES,HDFS-CH&AD DEV,138,8,130
1997,ACES,HDFS-FS,17,2,15
1998,ACES,HDFS-FS,36,2,34
1999,ACES,HDFS-FS,58,9,49
2000,ACES,HDFS-FS,61,4,57
2001,ACES,HDFS-FS,75,6,69
2002,ACES,HDFS-FS,69,8,61
2003,ACES,HDFS-FS,56,5,51
2016,Applied Health Sciences,Health,1,0,1
2016,Applied Health Sciences,Health,1,0,1
2015,Applied Health Sciences,Health,1,0,1
2015,Applied Health Sciences,Health,3,1,2
2014,Applied Health Sciences,Health,3,2,1
2014,Applied Health Sciences,Health,5,0,5
2014,Applied Health Sciences,Health,6,1,5
2014,Applied Health Sciences,Health,13,6,7
2013,Applied Health Sciences,Health,20,4,16
2013,Applied Health Sciences,Health,47,11,36
2013,Applied Health Sciences,Health,74,26,48
2013,Applied Health Sciences,Health,63,8,55
2013,Applied Health Sciences,Health,1,0,1
2012,Applied Health Sciences,Health,11,2,9
2012,Applied Health Sciences,Health,39,6,33
2012,Applied Health Sciences,Health,42,14,28
2012,Applied Health Sciences,Health,60,19,41
2012,Applied Health Sciences,Health,1,0,1
2011,Applied Health Sciences,Health,21,2,19
2011,Applied Health Sciences,Health,17,1,16
2011,Applied Health Sciences,Health,43,14,29
2011,Applied Health Sciences,Health,58,16,42
2010,Applied Health Sciences,Health,6,1,5
2010,Applied Health Sciences,Health,8,1,7
2010,Applied Health Sciences,Health,19,2,17
2010,Applied Health Sciences,Health,46,16,30
2009,Applied Health Sciences,Health,19,3,16
2018,LAS,Health Communication,27,2,25
2017,LAS,Health Communication,28,1,27
2011,LAS,Health Communication,1,0,1
1980,Applied Health Sciences,HEALTH&SAF,8,4,4
1981,Applied Health Sciences,HEALTH&SAF,12,6,6
1982,Applied Health Sciences,HEALTH&SAF,14,9,5
1984,Applied Health Sciences,HEALTH&SAF,6,5,1
1985,Applied Health Sciences,HEALTH&SAF,7,4,3
1986,Applied Health Sciences,HEALTH&SAF,5,3,2
2018,LAS,History,217,145,72
2018,LAS,History,19,9,10
2018,LAS,History,22,13,9
2018,LAS,History,81,48,33
2018,LAS,History,1,1,0
2017,LAS,History,200,135,65
2017,LAS,History,21,13,8
2017,LAS,History,22,11,11
2017,LAS,History,82,49,33
2017,LAS,History,1,1,0
2016,LAS,History,190,126,64
2016,LAS,History,20,14,6
2016,LAS,History,22,11,11
2016,LAS,History,84,50,34
2016,LAS,History,1,1,0
2015,LAS,History,11,7,4
2015,LAS,History,40,19,21
2015,LAS,History,1,1,0
2015,LAS,History,154,95,59
2015,LAS,History,95,51,44
2014,LAS,History,41,19,22
2014,LAS,History,1,1,0
2014,LAS,History,16,10,6
2014,LAS,History,180,118,62
2014,LAS,History,89,47,42
2013,LAS,History,23,13,10
2013,LAS,History,51,22,29
2013,LAS,History,217,148,67
2013,LAS,History,89,50,39
2012,LAS,History,22,8,14
2012,LAS,History,1,0,1
2012,LAS,History,62,31,31
2012,LAS,History,290,194,94
2012,LAS,History,93,50,43
2011,LAS,History,19,8,11
2011,LAS,History,3,3,0
2011,LAS,History,69,42,27
2011,LAS,History,346,236,109
2011,LAS,History,92,47,45
2010,LAS,History,12,5,7
2010,LAS,History,1,1,0
2010,LAS,History,82,44,38
2010,LAS,History,112,56,56
2010,LAS,History,392,275,116
2009,LAS,History,83,44,39
2009,LAS,History,1,1,0
2009,LAS,History,15,6,9
2009,LAS,History,409,281,127
2009,LAS,History,118,57,61
2008,LAS,History,94,57,37
2008,LAS,History,4,1,3
2008,LAS,History,439,299,139
2008,LAS,History,121,67,54
2007,LAS,History,95,52,43
2007,LAS,History,3,2,1
2007,LAS,History,494,324,168
2007,LAS,History,119,68,51
2006,LAS,History,86,43,43
2006,LAS,History,3,2,1
2006,LAS,History,476,304,171
2006,LAS,History,118,63,55
2005,LAS,History,4,2,2
2005,LAS,History,78,36,42
2005,LAS,History,488,314,173
2005,LAS,History,123,65,58
2004,LAS,History,518,339,179
2004,LAS,History,45,23,22
2004,LAS,History,108,60,48
1980,LAS,History,82,46,36
1981,LAS,History,84,60,24
1982,LAS,History,71,47,24
1983,LAS,History,73,47,26
1984,LAS,History,81,55,26
1985,LAS,History,83,53,30
1986,LAS,History,92,57,35
1987,LAS,History,102,64,38
1988,LAS,History,102,72,30
1989,LAS,History,129,88,41
1990,LAS,History,117,84,33
1991,LAS,History,150,105,45
1992,LAS,History,134,94,40
1993,LAS,History,127,95,32
1994,LAS,History,135,96,39
1995,LAS,History,123,84,39
1996,LAS,History,126,80,46
1997,LAS,History,116,78,38
1998,LAS,History,116,75,41
1999,LAS,History,106,70,36
2000,LAS,History,98,62,36
2001,LAS,History,98,63,35
2002,LAS,History,101,59,42
2003,LAS,History,99,56,43
2018,Fine and Applied Arts,History of Art,8,3,5
2017,Fine and Applied Arts,History of Art,7,1,6
2016,Fine and Applied Arts,History of Art,6,0,6
2015,Fine and Applied Arts,History of Art,5,0,5
2014,Fine and Applied Arts,History of Art,4,0,4
2013,Fine and Applied Arts,History of Art,10,1,9
2012,Fine and Applied Arts,History of Art,8,2,6
2011,Fine and Applied Arts,History of Art,10,1,9
2010,Fine and Applied Arts,History of Art,13,0,13
2009,Fine and Applied Arts,History of Art,13,0,13
2008,Fine and Applied Arts,History of Art,13,1,12
2007,Fine and Applied Arts,History of Art,8,0,8
2006,Fine and Applied Arts,History of Art,16,0,16
2005,Fine and Applied Arts,History of Art,22,3,19
2004,Fine and Applied Arts,History of Art,21,3,18
2018,LAS,History of Art,15,2,13
2018,LAS,History of Art,2,0,2
2017,LAS,History of Art,15,2,13
2017,LAS,History of Art,1,0,1
2016,LAS,History of Art,12,1,11
2016,LAS,History of Art,1,0,1
2015,LAS,History of Art,1,0,1
2015,LAS,History of Art,17,1,16
2014,LAS,History of Art,1,0,1
2014,LAS,History of Art,20,1,19
2013,LAS,History of Art,2,0,2
2013,LAS,History of Art,26,0,26
2012,LAS,History of Art,26,1,25
2011,LAS,History of Art,33,1,32
2010,LAS,History of Art,31,0,31
2009,LAS,History of Art,1,0,1
2009,LAS,History of Art,1,0,1
2009,LAS,History of Art,34,4,30
2008,LAS,History of Art,44,5,39
2007,LAS,History of Art,1,0,1
2007,LAS,History of Art,33,5,28
2006,LAS,History of Art,32,4,28
2005,LAS,History of Art,30,2,28
2004,LAS,History of Art,38,5,33
1980,Applied Health Sciences,HLTH EDUC,65,12,53
1981,Applied Health Sciences,HLTH EDUC,80,16,64
1982,Applied Health Sciences,HLTH EDUC,72,8,64
1983,Applied Health Sciences,HLTH EDUC,25,1,24
1984,Applied Health Sciences,HLTH EDUC,28,4,24
1985,Applied Health Sciences,HLTH EDUC,32,4,28
1986,Applied Health Sciences,HLTH EDUC,24,2,22
1987,Applied Health Sciences,HLTH EDUC,24,5,19
1988,Applied Health Sciences,HLTH EDUC,27,5,22
1989,Applied Health Sciences,HLTH EDUC,30,4,26
1990,Applied Health Sciences,HLTH EDUC,20,1,19
1991,Applied Health Sciences,HLTH EDUC,18,1,17
1992,Applied Health Sciences,HLTH EDUC,17,1,16
1993,Applied Health Sciences,HLTH EDUC,19,3,16
1994,Applied Health Sciences,HLTH EDUC,22,2,20
1995,Applied Health Sciences,HLTH EDUC,13,1,12
1996,Applied Health Sciences,HLTH EDUC,16,2,14
1997,Applied Health Sciences,HLTH EDUC,53,5,48
1998,Applied Health Sciences,HLTH EDUC,72,7,65
1999,Applied Health Sciences,HLTH EDUC,87,8,79
2000,Applied Health Sciences,HLTH EDUC,101,10,91
2001,Applied Health Sciences,HLTH EDUC,87,9,78
2002,Applied Health Sciences,HLTH EDUC,64,5,59
2003,Applied Health Sciences,HLTH EDUC,70,6,64
1982,Applied Health Sciences,HLTH PL AD,14,3,11
1983,Applied Health Sciences,HLTH PL AD,15,4,11
1984,Applied Health Sciences,HLTH PL AD,29,7,22
1985,Applied Health Sciences,HLTH PL AD,20,3,17
1986,Applied Health Sciences,HLTH PL AD,23,7,16
1987,Applied Health Sciences,HLTH PL AD,39,11,28
1988,Applied Health Sciences,HLTH PL AD,52,15,37
1989,Applied Health Sciences,HLTH PL AD,53,12,41
1990,Applied Health Sciences,HLTH PL AD,54,14,40
1991,Applied Health Sciences,HLTH PL AD,65,21,44
1992,Applied Health Sciences,HLTH PL AD,70,24,46
1993,Applied Health Sciences,HLTH PL AD,95,26,69
1994,Applied Health Sciences,HLTH PL AD,92,26,66
1995,Applied Health Sciences,HLTH PL AD,56,17,39
1996,Applied Health Sciences,HLTH PL AD,60,17,43
1997,Applied Health Sciences,HLTH PL AD,111,30,81
1998,Applied Health Sciences,HLTH PL AD,115,30,85
1999,Applied Health Sciences,HLTH PL AD,106,26,80
2000,Applied Health Sciences,HLTH PL AD,129,23,106
2001,Applied Health Sciences,HLTH PL AD,157,28,129
2002,Applied Health Sciences,HLTH PL AD,172,38,134
2003,Applied Health Sciences,HLTH PL AD,178,46,132
1997,ACES,HORT -- P&M,39,19,20
1998,ACES,HORT -- P&M,58,27,31
1999,ACES,HORT -- P&M,89,38,51
2000,ACES,HORT -- P&M,102,45,57
2001,ACES,HORT -- P&M,92,43,49
2002,ACES,HORT -- P&M,65,25,40
2003,ACES,HORT -- P&M,54,30,24
1997,ACES,HORT--HORT SCI,7,3,4
1998,ACES,HORT--HORT SCI,7,2,5
1999,ACES,HORT--HORT SCI,6,4,2
2000,ACES,HORT--HORT SCI,10,5,5
2001,ACES,HORT--HORT SCI,10,5,5
2002,ACES,HORT--HORT SCI,7,4,3
2003,ACES,HORT--HORT SCI,5,2,3
1980,ACES,Horticulture,17,6,11
1980,ACES,Horticulture,31,22,9
1981,ACES,Horticulture,26,10,16
1981,ACES,Horticulture,33,23,10
1982,ACES,Horticulture,21,11,10
1982,ACES,Horticulture,42,23,19
1983,ACES,Horticulture,24,15,9
1983,ACES,Horticulture,32,18,14
1984,ACES,Horticulture,19,13,6
1984,ACES,Horticulture,33,20,13
1985,ACES,Horticulture,16,9,7
1985,ACES,Horticulture,40,29,11
1986,ACES,Horticulture,10,5,5
1986,ACES,Horticulture,40,29,11
1987,ACES,Horticulture,11,5,6
1987,ACES,Horticulture,42,28,14
1988,ACES,Horticulture,10,5,5
1988,ACES,Horticulture,49,32,17
1989,ACES,Horticulture,17,8,9
1989,ACES,Horticulture,40,27,13
1990,ACES,Horticulture,11,5,6
1990,ACES,Horticulture,43,27,16
1991,ACES,Horticulture,19,12,7
1991,ACES,Horticulture,39,24,15
1992,ACES,Horticulture,15,8,7
1992,ACES,Horticulture,42,31,11
1993,ACES,Horticulture,15,7,8
1993,ACES,Horticulture,53,35,18
1994,ACES,Horticulture,25,16,9
1994,ACES,Horticulture,44,28,16
1995,ACES,Horticulture,20,6,14
1995,ACES,Horticulture,46,30,16
1996,ACES,Horticulture,10,4,6
1996,ACES,Horticulture,71,46,25
1997,ACES,Horticulture,7,5,2
1997,ACES,Horticulture,99,60,39
1998,ACES,Horticulture,18,11,7
1999,ACES,Horticulture,9,7,2
2000,ACES,Horticulture,6,3,3
2001,ACES,Horticulture,4,2,2
2002,ACES,Horticulture,2,1,1
2003,ACES,Horticulture,2,1,1
2018,ACES,Horticulture,1,0,1
2018,ACES,Horticulture,2,1,1
2017,ACES,Horticulture,2,0,2
2017,ACES,Horticulture,1,1,0
2016,ACES,Horticulture,2,0,2
2016,ACES,Horticulture,5,2,3
2016,ACES,Horticulture,1,0,1
2015,ACES,Horticulture,5,1,4
2015,ACES,Horticulture,19,5,14
2014,ACES,Horticulture,1,0,1
2014,ACES,Horticulture,7,4,3
2014,ACES,Horticulture,23,4,19
2013,ACES,Horticulture,1,0,1
2013,ACES,Horticulture,6,2,4
2013,ACES,Horticulture,18,8,10
2012,ACES,Horticulture,2,1,1
2012,ACES,Horticulture,1,1,0
2012,ACES,Horticulture,2,1,1
2012,ACES,Horticulture,3,3,0
2012,ACES,Horticulture,7,3,4
2012,ACES,Horticulture,19,12,7
2011,ACES,Horticulture,4,3,1
2011,ACES,Horticulture,1,1,0
2011,ACES,Horticulture,9,6,3
2011,ACES,Horticulture,3,1,2
2011,ACES,Horticulture,16,10,6
2010,ACES,Horticulture,3,1,2
2010,ACES,Horticulture,1,1,0
2010,ACES,Horticulture,5,2,3
2010,ACES,Horticulture,34,25,9
2009,ACES,Horticulture,2,1,1
2009,ACES,Horticulture,47,33,14
2009,ACES,Horticulture,2,0,2
2008,ACES,Horticulture,1,1,0
2008,ACES,Horticulture,5,2,3
2008,ACES,Horticulture,51,33,18
2007,ACES,Horticulture,1,1,0
2007,ACES,Horticulture,4,2,2
2007,ACES,Horticulture,2,1,1
2007,ACES,Horticulture,55,34,21
2006,ACES,Horticulture,4,4,0
2006,ACES,Horticulture,4,3,1
2006,ACES,Horticulture,64,40,24
2005,ACES,Horticulture,12,10,2
2005,ACES,Horticulture,6,4,2
2005,ACES,Horticulture,54,34,20
2004,ACES,Horticulture,6,5,1
2004,ACES,Horticulture,63,41,22
2004,ACES,Horticulture,5,4,1
1999,Labor and Industrial Relations,HR & IND RELS,123,39,84
2000,Labor and Industrial Relations,HR & IND RELS,146,48,98
2001,Labor and Industrial Relations,HR & IND RELS,144,51,93
2002,Labor and Industrial Relations,HR & IND RELS,166,63,103
2003,Labor and Industrial Relations,HR & IND RELS,162,54,108
1981,LAS,HR&FS,49,1,48
1983,LAS,HR&FS,37,1,36
1984,LAS,HR&FS,44,1,43
1985,LAS,HR&FS,35,1,34
1983,ACES,HR&FS A&ID,10,1,9
1984,ACES,HR&FS A&ID,12,1,11
1985,ACES,HR&FS A&ID,10,1,9
1986,ACES,HR&FS A&ID,11,1,10
1987,ACES,HR&FS A&ID,15,2,13
1988,ACES,HR&FS A&ID,15,5,10
1989,ACES,HR&FS A&ID,17,6,11
1990,ACES,HR&FS A&ID,10,2,8
1991,ACES,HR&FS A&ID,12,3,9
1992,ACES,HR&FS A&ID,17,5,12
1993,ACES,HR&FS A&ID,15,2,13
1994,ACES,HR&FS A&ID,15,1,14
1995,ACES,HR&FS A&ID,15,2,13
1996,ACES,HR&FS A&ID,9,1,8
1997,ACES,HR&FS A&ID,7,1,6
1988,ACES,HR&FS GEN,7,1,6
1989,ACES,HR&FS GEN,9,2,7
1990,ACES,HR&FS GEN,3,1,2
1980,ACES,HU DEV&FAM,14,1,13
1982,ACES,HU DEV&FAM,18,4,14
1983,ACES,HU DEV&FAM,28,5,23
1984,ACES,HU DEV&FAM,27,4,23
1985,ACES,HU DEV&FAM,18,1,17
1988,ACES,HU DEV&FAM,16,2,14
1989,ACES,HU DEV&FAM,19,2,17
1990,ACES,HU DEV&FAM,16,3,13
1991,ACES,HU DEV&FAM,24,1,23
1992,ACES,HU DEV&FAM,23,1,22
1993,ACES,HU DEV&FAM,27,6,21
1994,ACES,HU DEV&FAM,31,4,27
1995,ACES,HU DEV&FAM,34,5,29
1996,ACES,HU DEV&FAM,32,8,24
1997,ACES,HU DEV&FAM,28,6,22
1998,ACES,HU DEV&FAM,12,2,10
1999,ACES,HU DEV&FAM,7,2,5
2000,ACES,HU DEV&FAM,5,1,4
1998,ACES,Human & Community Development,11,2,9
1999,ACES,Human & Community Development,20,2,18
2000,ACES,Human & Community Development,23,6,17
2001,ACES,Human & Community Development,25,4,21
2002,ACES,Human & Community Development,28,5,23
2003,ACES,Human & Community Development,26,3,23
2018,ACES,Human & Community Development,1,0,1
2017,ACES,Human & Community Development,1,0,1
2016,ACES,Human & Community Development,7,2,5
2015,ACES,Human & Community Development,3,0,3
2015,ACES,Human & Community Development,1,1,0
2015,ACES,Human & Community Development,28,4,24
2014,ACES,Human & Community Development,2,0,2
2014,ACES,Human & Community Development,1,1,0
2014,ACES,Human & Community Development,23,5,18
2013,ACES,Human & Community Development,12,4,8
2013,ACES,Human & Community Development,10,3,7
2012,ACES,Human & Community Development,1,0,1
2012,ACES,Human & Community Development,10,3,7
2012,ACES,Human & Community Development,14,2,12
2011,ACES,Human & Community Development,1,0,1
2011,ACES,Human & Community Development,8,3,5
2011,ACES,Human & Community Development,19,4,15
2010,ACES,Human & Community Development,3,0,3
2010,ACES,Human & Community Development,8,3,5
2010,ACES,Human & Community Development,22,4,18
2009,ACES,Human & Community Development,3,0,3
2009,ACES,Human & Community Development,3,1,2
2009,ACES,Human & Community Development,24,4,20
2008,ACES,Human & Community Development,3,0,3
2008,ACES,Human & Community Development,25,4,21
2007,ACES,Human & Community Development,1,0,1
2007,ACES,Human & Community Development,4,1,3
2007,ACES,Human & Community Development,22,4,18
2006,ACES,Human & Community Development,1,1,0
2006,ACES,Human & Community Development,7,1,6
2006,ACES,Human & Community Development,20,4,16
2005,ACES,Human & Community Development,2,2,0
2005,ACES,Human & Community Development,7,0,7
2005,ACES,Human & Community Development,22,4,18
2004,ACES,Human & Community Development,5,0,5
2004,ACES,Human & Community Development,21,4,17
2018,ACES,Human Development & Family St,179,15,163
2018,ACES,Human Development & Family St,56,5,51
2018,ACES,Human Development & Family St,18,2,16
2017,ACES,Human Development & Family St,167,16,150
2017,ACES,Human Development & Family St,57,3,54
2016,ACES,Human Development & Family St,142,12,130
2016,ACES,Human Development & Family St,49,5,44
2015,ACES,Human Development & Family St,48,7,41
2015,ACES,Human Development & Family St,150,17,133
2014,ACES,Human Development & Family St,40,3,37
2014,ACES,Human Development & Family St,147,11,136
2013,ACES,Human Development & Family St,1,1,0
2013,ACES,Human Development & Family St,60,8,52
2013,ACES,Human Development & Family St,167,14,153
2012,ACES,Human Development & Family St,1,0,1
2012,ACES,Human Development & Family St,66,6,60
2012,ACES,Human Development & Family St,158,14,144
2011,ACES,Human Development & Family St,1,0,1
2011,ACES,Human Development & Family St,70,7,63
2011,ACES,Human Development & Family St,147,9,138
2010,ACES,Human Development & Family St,64,9,54
2010,ACES,Human Development & Family St,149,11,137
2009,ACES,Human Development & Family St,72,4,67
2009,ACES,Human Development & Family St,136,10,125
2008,ACES,Human Development & Family St,57,3,54
2008,ACES,Human Development & Family St,154,6,148
2007,ACES,Human Development & Family St,70,8,62
2007,ACES,Human Development & Family St,122,6,116
2006,ACES,Human Development & Family St,80,12,68
2006,ACES,Human Development & Family St,142,8,134
2005,ACES,Human Development & Family St,68,8,59
2005,ACES,Human Development & Family St,148,5,143
2004,ACES,Human Development & Family St,133,6,127
2004,ACES,Human Development & Family St,60,4,56
2018,ACES,Human Dvlpmt & Family Studies,24,1,23
2017,ACES,Human Dvlpmt & Family Studies,24,2,22
2016,ACES,Human Dvlpmt & Family Studies,25,3,22
2011,Aviation,Human Factors,1,1,0
2010,Aviation,Human Factors,6,2,4
2009,Aviation,Human Factors,11,3,8
2008,Aviation,Human Factors,12,6,6
2007,Aviation,Human Factors,10,8,2
2006,Aviation,Human Factors,8,6,2
2005,Aviation,Human Factors,6,3,3
2004,Aviation,Human Factors,4,2,2
2018,Labor and Industrial Relations,Human Res & Industrial Rels,186,50,136
2018,Labor and Industrial Relations,Human Res & Industrial Rels,50,14,36
2018,Labor and Industrial Relations,Human Res & Industrial Rels,15,10,5
2017,Labor and Industrial Relations,Human Res & Industrial Rels,194,68,126
2017,Labor and Industrial Relations,Human Res & Industrial Rels,48,11,37
2017,Labor and Industrial Relations,Human Res & Industrial Rels,16,11,5
2016,Labor and Industrial Relations,Human Res & Industrial Rels,173,50,123
2016,Labor and Industrial Relations,Human Res & Industrial Rels,13,9,4
2015,Labor and Industrial Relations,Human Res & Industrial Rels,11,6,5
2015,Labor and Industrial Relations,Human Res & Industrial Rels,175,52,123
2014,Labor and Industrial Relations,Human Res & Industrial Rels,9,4,5
2014,Labor and Industrial Relations,Human Res & Industrial Rels,199,59,140
2013,Labor and Industrial Relations,Human Res & Industrial Rels,13,5,8
2013,Labor and Industrial Relations,Human Res & Industrial Rels,182,60,121
2012,Labor and Industrial Relations,Human Res & Industrial Rels,13,5,8
2012,Labor and Industrial Relations,Human Res & Industrial Rels,182,60,122
2011,Labor and Industrial Relations,Human Res & Industrial Rels,12,5,7
2011,Labor and Industrial Relations,Human Res & Industrial Rels,179,51,128
2010,Labor and Industrial Relations,Human Res & Industrial Rels,13,7,6
2010,Labor and Industrial Relations,Human Res & Industrial Rels,165,50,115
2009,Labor and Industrial Relations,Human Res & Industrial Rels,13,8,5
2009,Labor and Industrial Relations,Human Res & Industrial Rels,178,50,128
2008,Labor and Industrial Relations,Human Res & Industrial Rels,13,8,5
2008,Labor and Industrial Relations,Human Res & Industrial Rels,175,50,125
2007,Labor and Industrial Relations,Human Res & Industrial Rels,12,5,7
2007,Labor and Industrial Relations,Human Res & Industrial Rels,165,50,115
2006,Labor and Industrial Relations,Human Res & Industrial Rels,17,5,12
2006,Labor and Industrial Relations,Human Res & Industrial Rels,153,50,103
2005,Labor and Industrial Relations,Human Res & Industrial Rels,15,4,11
2005,Labor and Industrial Relations,Human Res & Industrial Rels,126,47,79
2004,Labor and Industrial Relations,Human Res & Industrial Rels,135,53,82
2004,Labor and Industrial Relations,Human Res & Industrial Rels,14,3,11
2018,Education,Human Resource Education,1,1,0
2018,Education,Human Resource Education,7,4,3
2018,Education,Human Resource Education,11,4,7
2017,Education,Human Resource Education,1,1,0
2017,Education,Human Resource Education,1,1,0
2017,Education,Human Resource Education,7,3,4
2017,Education,Human Resource Education,12,4,8
2016,Education,Human Resource Education,2,1,1
2016,Education,Human Resource Education,1,0,1
2016,Education,Human Resource Education,8,3,5
2016,Education,Human Resource Education,19,8,11
2015,Education,Human Resource Education,1,0,1
2015,Education,Human Resource Education,1,1,0
2015,Education,Human Resource Education,5,3,2
2015,Education,Human Resource Education,10,5,5
2015,Education,Human Resource Education,20,7,13
2014,Education,Human Resource Education,4,0,4
2014,Education,Human Resource Education,13,2,11
2014,Education,Human Resource Education,13,6,7
2014,Education,Human Resource Education,25,10,15
2013,Education,Human Resource Education,1,1,0
2013,Education,Human Resource Education,3,0,3
2013,Education,Human Resource Education,2,0,2
2013,Education,Human Resource Education,2,0,2
2013,Education,Human Resource Education,2,1,1
2013,Education,Human Resource Education,12,5,7
2013,Education,Human Resource Education,16,1,15
2013,Education,Human Resource Education,23,11,12
2012,Education,Human Resource Education,1,1,0
2012,Education,Human Resource Education,2,0,2
2012,Education,Human Resource Education,1,0,1
2012,Education,Human Resource Education,3,0,3
2012,Education,Human Resource Education,13,5,8
2012,Education,Human Resource Education,22,11,11
2012,Education,Human Resource Education,4,3,1
2012,Education,Human Resource Education,10,0,10
2011,Education,Human Resource Education,1,1,0
2011,Education,Human Resource Education,6,4,2
2011,Education,Human Resource Education,1,0,1
2011,Education,Human Resource Education,7,3,4
2011,Education,Human Resource Education,7,1,6
2011,Education,Human Resource Education,1,1,0
2011,Education,Human Resource Education,3,1,2
2011,Education,Human Resource Education,23,14,9
2011,Education,Human Resource Education,25,7,18
2010,Education,Human Resource Education,3,2,1
2010,Education,Human Resource Education,1,1,0
2010,Education,Human Resource Education,1,0,1
2010,Education,Human Resource Education,8,6,2
2010,Education,Human Resource Education,7,3,4
2010,Education,Human Resource Education,3,2,1
2010,Education,Human Resource Education,10,2,8
2010,Education,Human Resource Education,27,7,20
2010,Education,Human Resource Education,29,18,11
2009,Education,Human Resource Education,3,2,1
2009,Education,Human Resource Education,2,2,0
2009,Education,Human Resource Education,2,1,1
2009,Education,Human Resource Education,4,1,3
2009,Education,Human Resource Education,4,1,3
2009,Education,Human Resource Education,3,0,3
2009,Education,Human Resource Education,33,14,19
2009,Education,Human Resource Education,27,18,9
2008,Education,Human Resource Education,7,4,3
2008,Education,Human Resource Education,3,0,3
2008,Education,Human Resource Education,32,6,26
2008,Education,Human Resource Education,37,21,16
2007,Education,Human Resource Education,1,0,1
2007,Education,Human Resource Education,1,0,1
2007,Education,Human Resource Education,8,4,4
2007,Education,Human Resource Education,3,0,3
2007,Education,Human Resource Education,26,10,16
2007,Education,Human Resource Education,43,21,22
2006,Education,Human Resource Education,1,0,1
2006,Education,Human Resource Education,2,1,1
2006,Education,Human Resource Education,1,1,0
2006,Education,Human Resource Education,10,5,5
2006,Education,Human Resource Education,8,4,4
2007,LAS,Humanities,3,3,0
2006,LAS,Humanities,8,3,5
2005,LAS,Humanities,7,5,2
2004,LAS,Humanities,16,6,10
2018,LAS,Individual Plans of Study,1,0,1
2018,LAS,Individual Plans of Study,12,5,7
2017,LAS,Individual Plans of Study,8,2,6
2016,LAS,Individual Plans of Study,1,0,1
2016,LAS,Individual Plans of Study,4,1,3
2015,LAS,Individual Plans of Study,7,3,4
2014,LAS,Individual Plans of Study,1,1,0
2014,LAS,Individual Plans of Study,6,1,5
2013,LAS,Individual Plans of Study,1,0,1
2013,LAS,Individual Plans of Study,5,1,4
2012,LAS,Individual Plans of Study,1,0,1
2012,LAS,Individual Plans of Study,3,2,1
2011,LAS,Individual Plans of Study,2,1,1
2011,LAS,Individual Plans of Study,3,3,0
2010,LAS,Individual Plans of Study,4,2,2
2010,LAS,Individual Plans of Study,4,4,0
2009,LAS,Individual Plans of Study,5,3,2
2009,LAS,Individual Plans of Study,4,3,1
2008,LAS,Individual Plans of Study,6,4,2
2008,LAS,Individual Plans of Study,1,0,1
2007,LAS,Individual Plans of Study,6,2,4
2006,LAS,Individual Plans of Study,9,7,2
2005,LAS,Individual Plans of Study,5,2,3
2004,LAS,Individual Plans of Study,3,0,3
2004,LAS,Individual Plans of Study,1,0,1
1980,ACES,Industrial Agriculture,70,57,13
1981,ACES,Industrial Agriculture,73,57,16
1982,ACES,Industrial Agriculture,56,43,13
1983,ACES,Industrial Agriculture,61,50,11
1984,ACES,Industrial Agriculture,79,63,16
1985,ACES,Industrial Agriculture,86,66,20
1986,ACES,Industrial Agriculture,89,69,20
1987,ACES,Industrial Agriculture,91,71,20
1988,ACES,Industrial Agriculture,91,68,23
1989,ACES,Industrial Agriculture,42,33,9
1990,ACES,Industrial Agriculture,13,9,4
1991,ACES,Industrial Agriculture,4,3,1
1980,Fine and Applied Arts,Industrial Design,97,56,41
1981,Fine and Applied Arts,Industrial Design,83,48,35
1982,Fine and Applied Arts,Industrial Design,95,45,50
1983,Fine and Applied Arts,Industrial Design,103,52,51
1984,Fine and Applied Arts,Industrial Design,116,52,64
1985,Fine and Applied Arts,Industrial Design,134,76,58
1986,Fine and Applied Arts,Industrial Design,117,71,46
1987,Fine and Applied Arts,Industrial Design,96,64,32
1988,Fine and Applied Arts,Industrial Design,88,60,28
1989,Fine and Applied Arts,Industrial Design,75,52,23
1990,Fine and Applied Arts,Industrial Design,80,57,23
1991,Fine and Applied Arts,Industrial Design,76,51,25
1992,Fine and Applied Arts,Industrial Design,74,46,28
1993,Fine and Applied Arts,Industrial Design,68,43,25
1994,Fine and Applied Arts,Industrial Design,66,44,22
1995,Fine and Applied Arts,Industrial Design,77,57,20
1996,Fine and Applied Arts,Industrial Design,82,62,20
1997,Fine and Applied Arts,Industrial Design,82,57,25
1998,Fine and Applied Arts,Industrial Design,77,52,25
1999,Fine and Applied Arts,Industrial Design,83,52,31
2000,Fine and Applied Arts,Industrial Design,79,47,32
2001,Fine and Applied Arts,Industrial Design,83,46,37
2002,Fine and Applied Arts,Industrial Design,75,39,36
2003,Fine and Applied Arts,Industrial Design,75,31,44
2018,Fine and Applied Arts,Industrial Design,201,99,102
2017,Fine and Applied Arts,Industrial Design,206,96,110
2016,Fine and Applied Arts,Industrial Design,186,80,106
2015,Fine and Applied Arts,Industrial Design,132,53,79
2014,Fine and Applied Arts,Industrial Design,113,54,59
2013,Fine and Applied Arts,Industrial Design,108,52,56
2012,Fine and Applied Arts,Industrial Design,110,55,55
2011,Fine and Applied Arts,Industrial Design,117,54,63
2010,Fine and Applied Arts,Industrial Design,112,53,59
2009,Fine and Applied Arts,Industrial Design,117,56,61
2008,Fine and Applied Arts,Industrial Design,107,57,50
2007,Fine and Applied Arts,Industrial Design,102,56,46
2006,Fine and Applied Arts,Industrial Design,100,54,46
2005,Fine and Applied Arts,Industrial Design,98,47,51
2004,Fine and Applied Arts,Industrial Design,85,43,42
1980,Engineering,Industrial Engineering,155,103,52
1980,Engineering,Industrial Engineering,11,9,2
1980,Engineering,Industrial Engineering,21,18,3
1981,Engineering,Industrial Engineering,158,115,43
1981,Engineering,Industrial Engineering,3,2,1
1981,Engineering,Industrial Engineering,9,8,1
1981,Engineering,Industrial Engineering,18,10,8
1982,Engineering,Industrial Engineering,144,98,46
1982,Engineering,Industrial Engineering,2,1,1
1982,Engineering,Industrial Engineering,11,9,2
1982,Engineering,Industrial Engineering,23,16,7
1983,Engineering,Industrial Engineering,128,83,45
1983,Engineering,Industrial Engineering,2,1,1
1983,Engineering,Industrial Engineering,7,5,2
1983,Engineering,Industrial Engineering,17,13,4
1984,Engineering,Industrial Engineering,116,81,35
1984,Engineering,Industrial Engineering,4,2,2
1984,Engineering,Industrial Engineering,7,3,4
1984,Engineering,Industrial Engineering,8,3,5
1985,Engineering,Industrial Engineering,136,96,40
1985,Engineering,Industrial Engineering,8,5,3
1985,Engineering,Industrial Engineering,12,6,6
1986,Engineering,Industrial Engineering,171,113,58
1986,Engineering,Industrial Engineering,10,6,4
1986,Engineering,Industrial Engineering,21,14,7
1987,Engineering,Industrial Engineering,173,122,51
1987,Engineering,Industrial Engineering,14,8,6
1987,Engineering,Industrial Engineering,14,10,4
1988,Engineering,Industrial Engineering,178,125,53
1988,Engineering,Industrial Engineering,2,1,1
1988,Engineering,Industrial Engineering,14,8,6
1988,Engineering,Industrial Engineering,15,12,3
1989,Engineering,Industrial Engineering,220,161,59
1989,Engineering,Industrial Engineering,4,3,1
1989,Engineering,Industrial Engineering,20,15,5
1989,Engineering,Industrial Engineering,17,13,4
1990,Engineering,Industrial Engineering,176,117,59
1990,Engineering,Industrial Engineering,17,12,5
1990,Engineering,Industrial Engineering,21,18,3
1991,Engineering,Industrial Engineering,136,91,45
1991,Engineering,Industrial Engineering,11,7,4
1991,Engineering,Industrial Engineering,21,17,4
1992,Engineering,Industrial Engineering,121,84,37
1992,Engineering,Industrial Engineering,6,5,1
1992,Engineering,Industrial Engineering,25,22,3
1993,Engineering,Industrial Engineering,110,72,38
1993,Engineering,Industrial Engineering,13,9,4
1993,Engineering,Industrial Engineering,29,20,9
1994,Engineering,Industrial Engineering,116,82,34
1994,Engineering,Industrial Engineering,18,13,5
1994,Engineering,Industrial Engineering,21,14,7
1995,Engineering,Industrial Engineering,114,84,30
1995,Engineering,Industrial Engineering,18,13,5
1995,Engineering,Industrial Engineering,18,14,4
1996,Engineering,Industrial Engineering,126,81,45
1996,Engineering,Industrial Engineering,2,1,1
1996,Engineering,Industrial Engineering,9,5,4
1996,Engineering,Industrial Engineering,19,15,4
1997,Engineering,Industrial Engineering,132,85,47
1997,Engineering,Industrial Engineering,11,8,3
1997,Engineering,Industrial Engineering,26,21,5
1998,Engineering,Industrial Engineering,124,81,43
1998,Engineering,Industrial Engineering,8,6,2
1998,Engineering,Industrial Engineering,25,23,2
1999,Engineering,Industrial Engineering,121,85,36
1999,Engineering,Industrial Engineering,5,3,2
1999,Engineering,Industrial Engineering,21,19,2
2000,Engineering,Industrial Engineering,99,69,30
2000,Engineering,Industrial Engineering,4,1,3
2000,Engineering,Industrial Engineering,20,16,4
2001,Engineering,Industrial Engineering,90,59,31
2001,Engineering,Industrial Engineering,3,1,2
2001,Engineering,Industrial Engineering,22,18,4
2002,Engineering,Industrial Engineering,84,58,26
2002,Engineering,Industrial Engineering,23,18,5
2003,Engineering,Industrial Engineering,66,44,22
2003,Engineering,Industrial Engineering,24,18,6
2018,Engineering,Industrial Engineering,271,202,69
2018,Engineering,Industrial Engineering,33,20,13
2018,Engineering,Industrial Engineering,1,0,1
2018,Engineering,Industrial Engineering,17,11,6
2018,Engineering,Industrial Engineering,45,29,16
2017,Engineering,Industrial Engineering,289,201,88
2017,Engineering,Industrial Engineering,35,28,7
2017,Engineering,Industrial Engineering,3,2,1
2017,Engineering,Industrial Engineering,21,14,7
2017,Engineering,Industrial Engineering,42,30,12
2016,Engineering,Industrial Engineering,274,194,80
2016,Engineering,Industrial Engineering,41,28,13
2016,Engineering,Industrial Engineering,2,1,1
2016,Engineering,Industrial Engineering,36,28,8
2015,Engineering,Industrial Engineering,30,21,9
2015,Engineering,Industrial Engineering,30,25,5
2015,Engineering,Industrial Engineering,277,201,76
2014,Engineering,Industrial Engineering,19,12,7
2014,Engineering,Industrial Engineering,30,25,5
2014,Engineering,Industrial Engineering,292,230,62
2013,Engineering,Industrial Engineering,12,7,5
2013,Engineering,Industrial Engineering,30,22,8
2013,Engineering,Industrial Engineering,254,201,53
2012,Engineering,Industrial Engineering,10,7,3
2012,Engineering,Industrial Engineering,35,24,11
2012,Engineering,Industrial Engineering,223,175,48
2011,Engineering,Industrial Engineering,8,6,2
2011,Engineering,Industrial Engineering,35,23,12
2011,Engineering,Industrial Engineering,183,139,44
2010,Engineering,Industrial Engineering,11,5,6
2010,Engineering,Industrial Engineering,29,18,11
2010,Engineering,Industrial Engineering,161,122,39
2009,Engineering,Industrial Engineering,10,5,5
2009,Engineering,Industrial Engineering,33,21,12
2009,Engineering,Industrial Engineering,116,86,30
2008,Engineering,Industrial Engineering,10,6,4
2008,Engineering,Industrial Engineering,28,18,10
2008,Engineering,Industrial Engineering,87,62,25
2007,Engineering,Industrial Engineering,1,1,0
2007,Engineering,Industrial Engineering,6,1,5
2007,Engineering,Industrial Engineering,13,11,2
2007,Engineering,Industrial Engineering,67,46,21
2006,Engineering,Industrial Engineering,1,1,0
2006,Engineering,Industrial Engineering,3,2,1
2006,Engineering,Industrial Engineering,6,5,1
2006,Engineering,Industrial Engineering,68,47,21
2006,Engineering,Industrial Engineering,1,1,0
2006,Engineering,Industrial Engineering,2,2,0
2005,Engineering,Industrial Engineering,4,2,2
2005,Engineering,Industrial Engineering,11,9,2
2005,Engineering,Industrial Engineering,66,43,23
2004,Engineering,Industrial Engineering,70,43,27
2004,Engineering,Industrial Engineering,9,6,3
2004,Engineering,Industrial Engineering,13,10,3
2018,Graduate,Informatics,45,26,19
2017,Graduate,Informatics,45,31,14
2016,Graduate,Informatics,32,25,7
2015,Graduate,Informatics,30,23,7
2014,Graduate,Informatics,27,21,6
2013,Graduate,Informatics,18,18,0
2012,LM,Informatics,14,14,0
2011,LM,Informatics,2,2,0
2018,iSchool,Information Management,262,126,136
2018,iSchool,Information Management,14,5,9
2017,iSchool,Information Management,178,86,92
2017,iSchool,Information Management,11,4,7
2016,iSchool,Information Management,42,20,22
2018,Business,Information Sys & Info Tech,46,30,16
2018,Business,Information Sys & Info Tech,57,27,30
2017,Business,Information Sys & Info Tech,49,32,17
2017,Business,Information Sys & Info Tech,64,33,31
2016,Business,Information Sys & Info Tech,35,20,15
2016,Business,Information Sys & Info Tech,48,28,20
2015,Business,Information Sys & Info Tech,24,15,9
2015,Business,Information Sys & Info Tech,23,13,10
2014,Business,Information Sys & Info Tech,22,16,6
2014,Business,Information Sys & Info Tech,29,21,8
2013,Business,Information Sys & Info Tech,15,11,4
2013,Business,Information Sys & Info Tech,33,26,7
2012,Business,Information Sys & Info Tech,12,7,5
2012,Business,Information Sys & Info Tech,22,21,1
2011,Business,Information Sys & Info Tech,19,15,4
2011,Business,Information Sys & Info Tech,16,13,3
2010,Business,Information Sys & Info Tech,18,12,6
2010,Business,Information Sys & Info Tech,14,13,1
2009,Business,Information Sys & Info Tech,5,3,2
2009,Business,Information Sys & Info Tech,32,27,5
2008,Business,Information Sys & Info Tech,2,1,1
2008,Business,Information Sys & Info Tech,23,18,5
2018,Business,Information Systems,22,12,9
2018,Business,Information Systems,3,2,1
2017,Business,Information Systems,3,3,0
1980,ACES,INST MGMT,8,1,7
1981,ACES,INST MGMT,8,1,7
1983,ACES,INST MGMT,9,1,8
1984,ACES,INST MGMT,7,2,5
1985,ACES,INST MGMT,9,3,6
1986,ACES,INST MGMT,5,1,4
1987,ACES,INST MGMT,7,1,6
1988,ACES,INST MGMT,4,1,3
2018,Fine and Applied Arts,Instrumental Music,77,30,47
2017,Fine and Applied Arts,Instrumental Music,75,32,43
2016,Fine and Applied Arts,Instrumental Music,78,30,48
2015,Fine and Applied Arts,Instrumental Music,76,33,43
2014,Fine and Applied Arts,Instrumental Music,71,33,38
2013,Fine and Applied Arts,Instrumental Music,77,39,38
2012,Fine and Applied Arts,Instrumental Music,75,35,40
2011,Fine and Applied Arts,Instrumental Music,89,40,49
2010,Fine and Applied Arts,Instrumental Music,82,34,48
2009,Fine and Applied Arts,Instrumental Music,94,43,51
2008,Fine and Applied Arts,Instrumental Music,102,47,55
2007,Fine and Applied Arts,Instrumental Music,118,55,63
2006,Fine and Applied Arts,Instrumental Music,136,61,74
2005,Fine and Applied Arts,Instrumental Music,122,52,70
2004,Fine and Applied Arts,Instrumental Music,112,55,57
1980,ACES,INT DSGN,140,9,131
1981,ACES,INT DSGN,168,9,159
1982,ACES,INT DSGN,172,10,162
1983,ACES,INT DSGN,163,9,154
1984,ACES,INT DSGN,148,4,144
1985,ACES,INT DSGN,143,10,133
1986,ACES,INT DSGN,131,8,123
1987,ACES,INT DSGN,114,7,107
1988,ACES,INT DSGN,101,6,95
1989,ACES,INT DSGN,89,3,86
1990,ACES,INT DSGN,62,3,59
1991,ACES,INT DSGN,22,1,21
2003,Business,INT'L MSBA,45,32,13
1998,Business,INT'L MSBA,42,27,15
1999,Business,INT'L MSBA,31,22,9
2000,Business,INT'L MSBA,39,23,16
2001,Business,INT'L MSBA,37,29,8
2002,Business,INT'L MSBA,43,24,19
2018,LAS,Integrative Biology,282,118,164
2018,LAS,Integrative Biology,5,3,2
2018,LAS,Integrative Biology,51,23,28
2018,LAS,Integrative Biology,9,3,6
2017,LAS,Integrative Biology,1,0,1
2017,LAS,Integrative Biology,316,136,180
2017,LAS,Integrative Biology,18,8,10
2017,LAS,Integrative Biology,45,17,28
2017,LAS,Integrative Biology,10,5,5
2016,LAS,Integrative Biology,1,0,1
2016,LAS,Integrative Biology,349,143,206
2016,LAS,Integrative Biology,10,6,4
2016,LAS,Integrative Biology,25,10,15
2016,LAS,Integrative Biology,7,1,6
2015,LAS,Integrative Biology,1,0,1
2015,LAS,Integrative Biology,12,5,7
2015,LAS,Integrative Biology,8,1,7
2015,LAS,Integrative Biology,34,13,21
2015,LAS,Integrative Biology,347,134,213
2014,LAS,Integrative Biology,4,0,4
2014,LAS,Integrative Biology,12,6,6
2014,LAS,Integrative Biology,33,9,24
2014,LAS,Integrative Biology,359,154,205
2013,LAS,Integrative Biology,5,1,4
2013,LAS,Integrative Biology,9,2,7
2013,LAS,Integrative Biology,3,0,3
2013,LAS,Integrative Biology,28,8,20
2013,LAS,Integrative Biology,383,166,217
2012,LAS,Integrative Biology,14,2,12
2012,LAS,Integrative Biology,23,10,13
2012,LAS,Integrative Biology,2,1,1
2012,LAS,Integrative Biology,10,0,10
2012,LAS,Integrative Biology,394,165,229
2011,LAS,Integrative Biology,12,5,7
2011,LAS,Integrative Biology,40,19,21
2011,LAS,Integrative Biology,4,2,2
2011,LAS,Integrative Biology,383,168,215
2010,LAS,Integrative Biology,2,1,1
2010,LAS,Integrative Biology,9,2,7
2010,LAS,Integrative Biology,33,12,21
2010,LAS,Integrative Biology,3,1,2
2010,LAS,Integrative Biology,314,136,178
2009,LAS,Integrative Biology,2,1,1
2009,LAS,Integrative Biology,1,1,0
2009,LAS,Integrative Biology,32,11,21
2009,LAS,Integrative Biology,294,132,162
2008,LAS,Integrative Biology,2,1,1
2008,LAS,Integrative Biology,46,19,27
2008,LAS,Integrative Biology,274,133,141
2007,LAS,Integrative Biology,5,1,4
2007,LAS,Integrative Biology,32,14,18
2007,LAS,Integrative Biology,255,123,132
2006,LAS,Integrative Biology,5,3,2
2006,LAS,Integrative Biology,5,3,2
2006,LAS,Integrative Biology,291,134,157
2005,LAS,Integrative Biology,6,4,2
2005,LAS,Integrative Biology,245,109,136
2004,LAS,Integrative Biology,188,82,106
2018,LAS,Interdisciplinary,2,1,1
2017,LAS,Interdisciplinary,1,1,0
2017,LAS,Interdisciplinary,1,0,1
2017,LAS,Interdisciplinary,1,0,1
2016,LAS,Interdisciplinary,1,1,0
2016,LAS,Interdisciplinary,1,0,1
2016,LAS,Interdisciplinary,1,0,1
2015,LAS,Interdisciplinary,1,0,1
2015,LAS,Interdisciplinary,3,2,1
2014,LAS,Interdisciplinary,1,0,1
2014,LAS,Interdisciplinary,1,0,1
2014,LAS,Interdisciplinary,2,1,1
2013,LAS,Interdisciplinary,2,0,2
2013,LAS,Interdisciplinary,1,0,1
2012,LAS,Interdisciplinary,3,0,3
2012,LAS,Interdisciplinary,1,0,1
2011,LAS,Interdisciplinary,4,2,2
2011,LAS,Interdisciplinary,1,0,1
2011,LAS,Interdisciplinary,1,0,1
2011,LAS,Interdisciplinary,4,4,0
2010,LAS,Interdisciplinary,3,0,3
2010,LAS,Interdisciplinary,2,0,2
2010,LAS,Interdisciplinary,1,0,1
2010,LAS,Interdisciplinary,10,7,3
2009,LAS,Interdisciplinary,1,0,1
2009,LAS,Interdisciplinary,13,1,12
2009,LAS,Interdisciplinary,2,0,2
2009,LAS,Interdisciplinary,2,2,0
2009,LAS,Interdisciplinary,20,14,6
2009,LAS,Interdisciplinary,7,2,5
2008,LAS,Interdisciplinary,1,1,0
2008,LAS,Interdisciplinary,19,3,16
2008,LAS,Interdisciplinary,11,4,7
2008,LAS,Interdisciplinary,34,23,11
2007,LAS,Interdisciplinary,12,7,5
2007,LAS,Interdisciplinary,16,1,15
2007,LAS,Interdisciplinary,21,14,7
2006,LAS,Interdisciplinary,10,5,5
2006,LAS,Interdisciplinary,1,0,1
2006,LAS,Interdisciplinary,6,0,6
2006,LAS,Interdisciplinary,2,2,0
2006,LAS,Interdisciplinary,1,0,1
2006,LAS,Interdisciplinary,19,13,6
2005,LAS,Interdisciplinary,6,2,4
2005,LAS,Interdisciplinary,4,1,3
2005,LAS,Interdisciplinary,4,0,4
2005,LAS,Interdisciplinary,4,3,1
2005,LAS,Interdisciplinary,20,12,8
2004,LAS,Interdisciplinary,13,7,6
2004,LAS,Interdisciplinary,1,1,0
2004,LAS,Interdisciplinary,9,4,5
2004,LAS,Interdisciplinary,3,0,3
2018,Applied Health Sciences,Interdisciplinary Health Sci,101,20,81
2018,Applied Health Sciences,Interdisciplinary Health Sci,46,12,34
2018,Applied Health Sciences,Interdisciplinary Health Sci,95,18,77
2018,Applied Health Sciences,Interdisciplinary Health Sci,86,10,76
2017,Applied Health Sciences,Interdisciplinary Health Sci,145,33,112
2017,Applied Health Sciences,Interdisciplinary Health Sci,26,3,23
2017,Applied Health Sciences,Interdisciplinary Health Sci,60,10,50
2017,Applied Health Sciences,Interdisciplinary Health Sci,54,8,46
2016,Applied Health Sciences,Interdisciplinary Health Sci,86,19,67
2016,Applied Health Sciences,Interdisciplinary Health Sci,34,5,29
2016,Applied Health Sciences,Interdisciplinary Health Sci,70,10,60
2016,Applied Health Sciences,Interdisciplinary Health Sci,49,8,41
2015,Applied Health Sciences,Interdisciplinary Health Sci,39,9,30
2015,Applied Health Sciences,Interdisciplinary Health Sci,79,16,63
2015,Applied Health Sciences,Interdisciplinary Health Sci,39,6,33
2015,Applied Health Sciences,Interdisciplinary Health Sci,43,9,34
2014,Applied Health Sciences,Interdisciplinary Health Sci,49,9,40
2014,Applied Health Sciences,Interdisciplinary Health Sci,36,8,28
2014,Applied Health Sciences,Interdisciplinary Health Sci,82,19,63
2014,Applied Health Sciences,Interdisciplinary Health Sci,35,9,26
2013,LAS,International Studies,1,1,0
2012,LAS,International Studies,1,0,1
2012,LAS,International Studies,5,3,2
2011,LAS,International Studies,3,0,3
2011,LAS,International Studies,44,12,31
2010,LAS,International Studies,14,1,13
2010,LAS,International Studies,118,32,85
2009,LAS,International Studies,17,3,14
2009,LAS,International Studies,299,88,210
2008,LAS,International Studies,4,2,2
2008,LAS,International Studies,398,109,288
2007,LAS,International Studies,4,1,3
2007,LAS,International Studies,365,107,258
2006,LAS,International Studies,4,2,2
2006,LAS,International Studies,352,100,252
2005,LAS,International Studies,6,3,3
2005,LAS,International Studies,311,89,222
2004,LAS,International Studies,255,93,162
2009,ACES,"Intl, Resource, Consumer Econ ",1,1,0
2009,ACES,"Intl, Resource, Consumer Econ ",1,1,0
2008,ACES,"Intl, Resource, Consumer Econ ",8,6,2
2008,ACES,"Intl, Resource, Consumer Econ ",8,6,2
2008,ACES,"Intl, Resource, Consumer Econ ",4,1,3
2007,ACES,"Intl, Resource, Consumer Econ ",27,15,12
2007,ACES,"Intl, Resource, Consumer Econ ",20,12,8
2007,ACES,"Intl, Resource, Consumer Econ ",8,3,5
2006,ACES,"Intl, Resource, Consumer Econ ",68,44,24
2006,ACES,"Intl, Resource, Consumer Econ ",12,4,8
2006,ACES,"Intl, Resource, Consumer Econ ",36,20,16
2005,ACES,"Intl, Resource, Consumer Econ ",1,1,0
2005,ACES,"Intl, Resource, Consumer Econ ",104,67,37
2005,ACES,"Intl, Resource, Consumer Econ ",16,7,9
2005,ACES,"Intl, Resource, Consumer Econ ",53,30,23
2004,ACES,"Intl, Resource, Consumer Econ ",101,68,33
2004,ACES,"Intl, Resource, Consumer Econ ",8,6,2
2004,ACES,"Intl, Resource, Consumer Econ ",3,2,1
2004,ACES,"Intl, Resource, Consumer Econ ",64,38,26
1998,ACES,INTRSRCCNSECON,2,1,1
1997,ACES,IRCE-CONS EC&F,32,18,14
1998,ACES,IRCE-CONS EC&F,50,35,15
1999,ACES,IRCE-CONS EC&F,77,47,30
2000,ACES,IRCE-CONS EC&F,76,51,25
2001,ACES,IRCE-CONS EC&F,90,59,31
2002,ACES,IRCE-CONS EC&F,89,48,41
2003,ACES,IRCE-CONS EC&F,87,54,33
1997,ACES,IRCE-E&NR MGMT,4,2,2
1998,ACES,IRCE-E&NR MGMT,6,4,2
1999,ACES,IRCE-E&NR MGMT,4,3,1
2000,ACES,IRCE-E&NR MGMT,8,4,4
2001,ACES,IRCE-E&NR MGMT,6,2,4
2002,ACES,IRCE-E&NR MGMT,6,4,2
1997,ACES,IRCE-INDCURRIC,11,7,4
1998,ACES,IRCE-INDCURRIC,9,7,2
2000,ACES,IRCE-INDCURRIC,8,7,1
2001,ACES,IRCE-INDCURRIC,7,4,3
2002,ACES,IRCE-INDCURRIC,10,5,5
2003,ACES,IRCE-INDCURRIC,9,6,3
1997,ACES,"IRCE-POL,TRD,DV",10,6,4
1998,ACES,"IRCE-POL,TRD,DV",25,12,13
1999,ACES,"IRCE-POL,TRD,DV",26,13,13
2000,ACES,"IRCE-POL,TRD,DV",42,20,22
2001,ACES,"IRCE-POL,TRD,DV",36,17,19
2002,ACES,"IRCE-POL,TRD,DV",33,22,11
2003,ACES,"IRCE-POL,TRD,DV",37,21,16
2018,LAS,Italian,2,0,2
2018,LAS,Italian,3,1,2
2018,LAS,Italian,2,2,0
2017,LAS,Italian,2,1,1
2017,LAS,Italian,3,1,2
2017,LAS,Italian,3,2,1
2016,LAS,Italian,3,1,2
2016,LAS,Italian,5,0,5
2016,LAS,Italian,3,2,1
2016,LAS,Italian,1,1,0
2015,LAS,Italian,2,2,0
2015,LAS,Italian,1,1,0
2015,LAS,Italian,3,0,3
2015,LAS,Italian,3,2,1
2014,LAS,Italian,2,2,0
2014,LAS,Italian,1,0,1
2014,LAS,Italian,1,0,1
2014,LAS,Italian,1,1,0
2013,LAS,Italian,4,3,1
2013,LAS,Italian,1,0,1
2013,LAS,Italian,1,0,1
2013,LAS,Italian,1,1,0
2012,LAS,Italian,3,2,1
2012,LAS,Italian,1,0,1
2012,LAS,Italian,3,1,2
2011,LAS,Italian,3,2,1
2011,LAS,Italian,1,0,1
2011,LAS,Italian,2,1,1
2010,LAS,Italian,5,1,4
2010,LAS,Italian,1,1,0
2010,LAS,Italian,1,0,1
2009,LAS,Italian,8,3,5
2009,LAS,Italian,4,3,1
2009,LAS,Italian,2,0,2
2008,LAS,Italian,7,3,4
2008,LAS,Italian,1,0,1
2008,LAS,Italian,3,2,1
2008,LAS,Italian,3,0,3
2007,LAS,Italian,6,4,2
2007,LAS,Italian,1,0,1
2007,LAS,Italian,2,1,1
2007,LAS,Italian,2,0,2
2006,LAS,Italian,6,1,5
2006,LAS,Italian,1,0,1
2006,LAS,Italian,2,0,2
2006,LAS,Italian,3,1,2
2005,LAS,Italian,1,0,1
2005,LAS,Italian,7,1,6
2005,LAS,Italian,2,1,1
2004,LAS,Italian,6,1,5
2004,LAS,Italian,1,0,1
2004,LAS,Italian,3,1,2
1981,LAS,Italian,5,2,3
1982,LAS,Italian,5,2,3
1983,LAS,Italian,5,1,4
1984,LAS,Italian,6,1,5
1985,LAS,Italian,6,2,4
1986,LAS,Italian,9,3,6
1987,LAS,Italian,6,3,3
1988,LAS,Italian,7,2,5
1992,LAS,Italian,5,1,4
1993,LAS,Italian,6,1,5
1994,LAS,Italian,6,1,5
2002,LAS,Italian,4,1,3
2003,LAS,Italian,3,1,2
2018,Fine and Applied Arts,Jazz Performance,31,25,6
2017,Fine and Applied Arts,Jazz Performance,28,23,5
2016,Fine and Applied Arts,Jazz Performance,37,32,5
2015,Fine and Applied Arts,Jazz Performance,31,30,1
2014,Fine and Applied Arts,Jazz Performance,27,24,3
2013,Fine and Applied Arts,Jazz Performance,22,19,3
2012,Fine and Applied Arts,Jazz Performance,22,20,2
2011,Fine and Applied Arts,Jazz Performance,27,23,4
2010,Fine and Applied Arts,Jazz Performance,33,27,6
2009,Fine and Applied Arts,Jazz Performance,41,36,5
2008,Fine and Applied Arts,Jazz Performance,38,35,3
2007,Fine and Applied Arts,Jazz Performance,21,20,1
2018,Media,Journalism,222,87,135
2018,Media,Journalism,5,3,2
2018,Media,Journalism,1,0,1
2017,Media,Journalism,232,81,151
2017,Media,Journalism,6,2,4
2017,Media,Journalism,1,1,0
2016,Media,Journalism,201,75,126
2016,Media,Journalism,6,0,6
2016,Media,Journalism,2,1,1
2015,Media,Journalism,2,1,1
2015,Media,Journalism,8,3,5
2015,Media,Journalism,131,49,82
2014,Media,Journalism,10,3,7
2014,Media,Journalism,80,24,56
2013,Media,Journalism,13,5,8
2012,Media,Journalism,11,9,2
2011,Media,Journalism,13,4,9
2010,Media,Journalism,20,7,13
2009,Media,Journalism,25,8,17
2008,Media,Journalism,26,12,14
2007,Media,Journalism,26,14,12
2006,Media,Journalism,26,10,16
2005,Media,Journalism,31,11,20
2004,Media,Journalism,33,9,24
1980,Media,Journalism,171,62,109
1980,Media,Journalism,32,13,19
1981,Media,Journalism,43,21,22
1982,Media,Journalism,37,16,21
1983,Media,Journalism,48,23,25
1984,Media,Journalism,47,23,24
1985,Media,Journalism,37,15,22
1986,Media,Journalism,33,14,19
1987,Media,Journalism,34,13,21
1988,Media,Journalism,29,10,19
1989,Media,Journalism,28,11,17
1990,Media,Journalism,34,12,22
1991,Media,Journalism,30,9,21
1992,Media,Journalism,25,13,12
1993,Media,Journalism,28,13,15
1994,Media,Journalism,29,10,19
1995,Media,Journalism,30,9,21
1996,Media,Journalism,26,12,14
1997,Media,Journalism,24,13,11
1998,Media,Journalism,24,10,14
1999,Media,Journalism,23,12,11
2000,Media,Journalism,23,9,14
2001,Media,Journalism,28,9,19
2002,Media,Journalism,30,6,24
2003,Media,Journalism,29,8,21
1980,Applied Health Sciences,Kinesiology,60,36,24
1980,Applied Health Sciences,Kinesiology,208,89,119
1981,Applied Health Sciences,Kinesiology,76,41,35
1981,Applied Health Sciences,Kinesiology,208,103,105
1982,Applied Health Sciences,Kinesiology,59,34,25
1982,Applied Health Sciences,Kinesiology,194,86,108
1983,Applied Health Sciences,Kinesiology,76,44,32
1983,Applied Health Sciences,Kinesiology,160,88,72
1984,Applied Health Sciences,Kinesiology,99,54,45
1984,Applied Health Sciences,Kinesiology,152,66,86
1985,Applied Health Sciences,Kinesiology,110,62,48
1985,Applied Health Sciences,Kinesiology,137,76,61
1986,Applied Health Sciences,Kinesiology,102,58,44
1986,Applied Health Sciences,Kinesiology,116,56,60
1987,Applied Health Sciences,Kinesiology,87,50,37
1987,Applied Health Sciences,Kinesiology,125,62,63
1988,Applied Health Sciences,Kinesiology,74,40,34
1988,Applied Health Sciences,Kinesiology,146,67,79
1989,Applied Health Sciences,Kinesiology,83,47,36
1989,Applied Health Sciences,Kinesiology,154,90,64
1990,Applied Health Sciences,Kinesiology,95,52,43
1990,Applied Health Sciences,Kinesiology,162,98,64
1991,Applied Health Sciences,Kinesiology,87,46,41
1991,Applied Health Sciences,Kinesiology,181,97,84
1992,Applied Health Sciences,Kinesiology,92,53,39
1992,Applied Health Sciences,Kinesiology,216,123,93
1993,Applied Health Sciences,Kinesiology,79,45,34
1993,Applied Health Sciences,Kinesiology,137,80,57
1994,Applied Health Sciences,Kinesiology,65,36,29
1994,Applied Health Sciences,Kinesiology,109,50,59
1995,Applied Health Sciences,Kinesiology,70,43,27
1995,Applied Health Sciences,Kinesiology,121,52,69
1996,Applied Health Sciences,Kinesiology,77,40,37
1996,Applied Health Sciences,Kinesiology,3,2,1
1997,Applied Health Sciences,Kinesiology,67,40,27
1997,Applied Health Sciences,Kinesiology,4,2,2
1998,Applied Health Sciences,Kinesiology,56,28,28
1999,Applied Health Sciences,Kinesiology,56,29,27
2000,Applied Health Sciences,Kinesiology,48,25,23
2001,Applied Health Sciences,Kinesiology,57,29,28
2002,Applied Health Sciences,Kinesiology,61,29,32
2003,Applied Health Sciences,Kinesiology,60,25,35
1995,Applied Health Sciences,Kinesiology,13,6,7
1996,Applied Health Sciences,Kinesiology,15,10,5
1997,Applied Health Sciences,Kinesiology,16,9,7
1998,Applied Health Sciences,Kinesiology,22,13,9
1999,Applied Health Sciences,Kinesiology,12,6,6
2000,Applied Health Sciences,Kinesiology,21,8,13
2001,Applied Health Sciences,Kinesiology,13,4,9
2002,Applied Health Sciences,Kinesiology,19,5,14
2003,Applied Health Sciences,Kinesiology,45,21,24
2002,Applied Health Sciences,Kinesiology,39,13,26
2003,Applied Health Sciences,Kinesiology,33,12,21
1993,Applied Health Sciences,Kinesiology,165,82,83
1994,Applied Health Sciences,Kinesiology,265,140,125
1995,Applied Health Sciences,Kinesiology,249,115,134
1996,Applied Health Sciences,Kinesiology,382,159,223
1997,Applied Health Sciences,Kinesiology,410,177,233
1998,Applied Health Sciences,Kinesiology,421,169,252
1999,Applied Health Sciences,Kinesiology,395,166,229
2000,Applied Health Sciences,Kinesiology,381,147,234
2001,Applied Health Sciences,Kinesiology,416,159,257
2002,Applied Health Sciences,Kinesiology,397,161,236
2003,Applied Health Sciences,Kinesiology,406,143,263
2018,Applied Health Sciences,Kinesiology,550,249,301
2018,Applied Health Sciences,Kinesiology,14,2,12
2018,Applied Health Sciences,Kinesiology,18,6,12
2018,Applied Health Sciences,Kinesiology,52,29,23
2017,Applied Health Sciences,Kinesiology,567,239,328
2017,Applied Health Sciences,Kinesiology,8,6,2
2017,Applied Health Sciences,Kinesiology,21,9,12
2017,Applied Health Sciences,Kinesiology,47,21,26
2016,Applied Health Sciences,Kinesiology,546,229,317
2016,Applied Health Sciences,Kinesiology,11,8,3
2016,Applied Health Sciences,Kinesiology,18,12,6
2016,Applied Health Sciences,Kinesiology,54,26,28
2015,Applied Health Sciences,Kinesiology,10,6,4
2015,Applied Health Sciences,Kinesiology,17,9,8
2015,Applied Health Sciences,Kinesiology,57,29,28
2015,Applied Health Sciences,Kinesiology,537,221,316
2014,Applied Health Sciences,Kinesiology,17,7,10
2014,Applied Health Sciences,Kinesiology,17,7,10
2014,Applied Health Sciences,Kinesiology,57,29,28
2014,Applied Health Sciences,Kinesiology,544,224,320
2013,Applied Health Sciences,Kinesiology,24,14,10
2013,Applied Health Sciences,Kinesiology,17,10,7
2013,Applied Health Sciences,Kinesiology,50,27,23
2013,Applied Health Sciences,Kinesiology,521,214,307
2012,Applied Health Sciences,Kinesiology,22,14,8
2012,Applied Health Sciences,Kinesiology,20,10,10
2012,Applied Health Sciences,Kinesiology,45,27,18
2012,Applied Health Sciences,Kinesiology,546,221,325
2011,Applied Health Sciences,Kinesiology,27,18,9
2011,Applied Health Sciences,Kinesiology,15,7,8
2011,Applied Health Sciences,Kinesiology,52,26,26
2011,Applied Health Sciences,Kinesiology,554,219,334
2010,Applied Health Sciences,Kinesiology,1,0,1
2010,Applied Health Sciences,Kinesiology,27,20,7
2010,Applied Health Sciences,Kinesiology,17,7,10
2010,Applied Health Sciences,Kinesiology,55,25,30
2010,Applied Health Sciences,Kinesiology,552,227,324
2009,Applied Health Sciences,Kinesiology,8,3,5
2009,Applied Health Sciences,Kinesiology,51,35,15
2009,Applied Health Sciences,Kinesiology,27,13,14
2009,Applied Health Sciences,Kinesiology,516,204,312
2009,Applied Health Sciences,Kinesiology,54,26,28
2008,Applied Health Sciences,Kinesiology,25,11,14
2008,Applied Health Sciences,Kinesiology,43,25,17
2008,Applied Health Sciences,Kinesiology,33,12,21
2008,Applied Health Sciences,Kinesiology,45,23,22
2008,Applied Health Sciences,Kinesiology,526,210,316
2007,Applied Health Sciences,Kinesiology,27,7,20
2007,Applied Health Sciences,Kinesiology,35,20,15
2007,Applied Health Sciences,Kinesiology,30,13,17
2007,Applied Health Sciences,Kinesiology,36,15,21
2007,Applied Health Sciences,Kinesiology,527,202,324
2006,Applied Health Sciences,Kinesiology,1,1,0
2006,Applied Health Sciences,Kinesiology,46,23,23
2006,Applied Health Sciences,Kinesiology,40,11,29
2006,Applied Health Sciences,Kinesiology,35,16,19
2006,Applied Health Sciences,Kinesiology,32,14,18
2006,Applied Health Sciences,Kinesiology,523,194,329
2005,Applied Health Sciences,Kinesiology,2,0,2
2005,Applied Health Sciences,Kinesiology,44,16,28
2005,Applied Health Sciences,Kinesiology,30,21,9
2005,Applied Health Sciences,Kinesiology,30,9,21
2005,Applied Health Sciences,Kinesiology,28,11,17
2005,Applied Health Sciences,Kinesiology,524,204,320
2004,Applied Health Sciences,Kinesiology,474,167,307
2004,Applied Health Sciences,Kinesiology,33,19,14
2004,Applied Health Sciences,Kinesiology,36,9,27
2004,Applied Health Sciences,Kinesiology,28,9,19
2004,Applied Health Sciences,Kinesiology,26,11,15
1980,Labor and Industrial Relations,LAB&IN REL,79,47,32
1981,Labor and Industrial Relations,LAB&IN REL,64,40,24
1982,Labor and Industrial Relations,LAB&IN REL,74,43,31
1983,Labor and Industrial Relations,LAB&IN REL,70,39,31
1984,Labor and Industrial Relations,LAB&IN REL,65,33,32
1985,Labor and Industrial Relations,LAB&IN REL,62,31,31
1986,Labor and Industrial Relations,LAB&IN REL,81,40,41
1987,Labor and Industrial Relations,LAB&IN REL,83,41,42
1988,Labor and Industrial Relations,LAB&IN REL,89,42,47
1989,Labor and Industrial Relations,LAB&IN REL,85,31,54
1990,Labor and Industrial Relations,LAB&IN REL,108,44,64
1991,Labor and Industrial Relations,LAB&IN REL,122,48,74
1992,Labor and Industrial Relations,LAB&IN REL,108,33,75
1993,Labor and Industrial Relations,LAB&IN REL,110,33,77
1994,Labor and Industrial Relations,LAB&IN REL,102,32,70
1995,Labor and Industrial Relations,LAB&IN REL,109,32,77
1996,Labor and Industrial Relations,LAB&IN REL,123,44,79
1997,Labor and Industrial Relations,LAB&IN REL,117,49,68
1998,Labor and Industrial Relations,LAB&IN REL,104,35,69
1999,Labor and Industrial Relations,LAB&IN REL,6,3,3
1980,Fine and Applied Arts,Landscape Architecture,127,86,41
1980,Fine and Applied Arts,Landscape Architecture,31,11,20
1981,Fine and Applied Arts,Landscape Architecture,123,83,40
1981,Fine and Applied Arts,Landscape Architecture,36,14,22
1982,Fine and Applied Arts,Landscape Architecture,109,73,36
1982,Fine and Applied Arts,Landscape Architecture,37,17,20
1983,Fine and Applied Arts,Landscape Architecture,103,72,31
1983,Fine and Applied Arts,Landscape Architecture,39,21,18
1984,Fine and Applied Arts,Landscape Architecture,99,74,25
1984,Fine and Applied Arts,Landscape Architecture,35,16,19
1985,Fine and Applied Arts,Landscape Architecture,101,73,28
1985,Fine and Applied Arts,Landscape Architecture,36,12,24
1986,Fine and Applied Arts,Landscape Architecture,99,69,30
1986,Fine and Applied Arts,Landscape Architecture,36,15,21
1987,Fine and Applied Arts,Landscape Architecture,95,76,19
1987,Fine and Applied Arts,Landscape Architecture,43,22,21
1988,Fine and Applied Arts,Landscape Architecture,92,67,25
1988,Fine and Applied Arts,Landscape Architecture,41,20,21
1989,Fine and Applied Arts,Landscape Architecture,102,70,32
1989,Fine and Applied Arts,Landscape Architecture,31,13,18
1990,Fine and Applied Arts,Landscape Architecture,106,75,31
1990,Fine and Applied Arts,Landscape Architecture,34,14,20
1991,Fine and Applied Arts,Landscape Architecture,112,80,32
1991,Fine and Applied Arts,Landscape Architecture,37,17,20
1992,Fine and Applied Arts,Landscape Architecture,99,67,32
1992,Fine and Applied Arts,Landscape Architecture,37,13,24
1993,Fine and Applied Arts,Landscape Architecture,91,60,31
1993,Fine and Applied Arts,Landscape Architecture,46,14,32
1994,Fine and Applied Arts,Landscape Architecture,94,61,33
1994,Fine and Applied Arts,Landscape Architecture,48,17,31
1995,Fine and Applied Arts,Landscape Architecture,117,76,41
1995,Fine and Applied Arts,Landscape Architecture,42,15,27
1996,Fine and Applied Arts,Landscape Architecture,103,70,33
1996,Fine and Applied Arts,Landscape Architecture,33,14,19
1997,Fine and Applied Arts,Landscape Architecture,109,73,36
1997,Fine and Applied Arts,Landscape Architecture,26,10,16
1998,Fine and Applied Arts,Landscape Architecture,110,72,38
1998,Fine and Applied Arts,Landscape Architecture,31,14,17
1999,Fine and Applied Arts,Landscape Architecture,104,63,41
1999,Fine and Applied Arts,Landscape Architecture,33,15,18
2000,Fine and Applied Arts,Landscape Architecture,111,70,41
2000,Fine and Applied Arts,Landscape Architecture,35,17,18
2001,Fine and Applied Arts,Landscape Architecture,111,65,46
2001,Fine and Applied Arts,Landscape Architecture,38,15,23
2002,Fine and Applied Arts,Landscape Architecture,119,73,46
2002,Fine and Applied Arts,Landscape Architecture,34,12,22
2003,Fine and Applied Arts,Landscape Architecture,116,67,49
2003,Fine and Applied Arts,Landscape Architecture,35,10,25
2018,Fine and Applied Arts,Landscape Architecture,50,20,30
2018,Fine and Applied Arts,Landscape Architecture,44,6,38
2018,Fine and Applied Arts,Landscape Architecture,1,0,1
2018,Fine and Applied Arts,Landscape Architecture,13,6,7
2017,Fine and Applied Arts,Landscape Architecture,53,18,35
2017,Fine and Applied Arts,Landscape Architecture,44,5,39
2017,Fine and Applied Arts,Landscape Architecture,14,5,9
2016,Fine and Applied Arts,Landscape Architecture,59,29,30
2016,Fine and Applied Arts,Landscape Architecture,61,11,50
2016,Fine and Applied Arts,Landscape Architecture,12,4,8
2015,Fine and Applied Arts,Landscape Architecture,13,5,8
2015,Fine and Applied Arts,Landscape Architecture,63,27,36
2015,Fine and Applied Arts,Landscape Architecture,51,9,42
2014,Fine and Applied Arts,Landscape Architecture,13,5,8
2014,Fine and Applied Arts,Landscape Architecture,69,32,37
2014,Fine and Applied Arts,Landscape Architecture,38,9,29
2013,Fine and Applied Arts,Landscape Architecture,27,6,21
2013,Fine and Applied Arts,Landscape Architecture,14,7,7
2013,Fine and Applied Arts,Landscape Architecture,56,26,30
2012,Fine and Applied Arts,Landscape Architecture,6,4,2
2012,Fine and Applied Arts,Landscape Architecture,51,26,25
2012,Fine and Applied Arts,Landscape Architecture,1,0,1
2012,Fine and Applied Arts,Landscape Architecture,42,12,30
2012,Fine and Applied Arts,Landscape Architecture,13,8,5
2011,Fine and Applied Arts,Landscape Architecture,2,2,0
2011,Fine and Applied Arts,Landscape Architecture,31,8,23
2011,Fine and Applied Arts,Landscape Architecture,71,36,35
2011,Fine and Applied Arts,Landscape Architecture,14,7,7
2010,Fine and Applied Arts,Landscape Architecture,54,25,29
2010,Fine and Applied Arts,Landscape Architecture,31,13,18
2010,Fine and Applied Arts,Landscape Architecture,30,19,11
2010,Fine and Applied Arts,Landscape Architecture,12,7,5
2009,Fine and Applied Arts,Landscape Architecture,51,35,16
2009,Fine and Applied Arts,Landscape Architecture,43,21,22
2009,Fine and Applied Arts,Landscape Architecture,10,7,3
2009,Fine and Applied Arts,Landscape Architecture,35,13,22
2008,Fine and Applied Arts,Landscape Architecture,1,0,1
2008,Fine and Applied Arts,Landscape Architecture,15,7,8
2008,Fine and Applied Arts,Landscape Architecture,10,5,5
2008,Fine and Applied Arts,Landscape Architecture,95,62,33
2008,Fine and Applied Arts,Landscape Architecture,34,13,21
2007,Fine and Applied Arts,Landscape Architecture,8,4,4
2007,Fine and Applied Arts,Landscape Architecture,111,76,35
2007,Fine and Applied Arts,Landscape Architecture,28,9,19
2006,Fine and Applied Arts,Landscape Architecture,3,3,0
2006,Fine and Applied Arts,Landscape Architecture,8,4,4
2006,Fine and Applied Arts,Landscape Architecture,110,68,42
2006,Fine and Applied Arts,Landscape Architecture,30,9,21
2005,Fine and Applied Arts,Landscape Architecture,3,3,0
2005,Fine and Applied Arts,Landscape Architecture,111,77,34
2005,Fine and Applied Arts,Landscape Architecture,5,1,4
2005,Fine and Applied Arts,Landscape Architecture,39,12,27
2004,Fine and Applied Arts,Landscape Architecture,125,72,53
2004,Fine and Applied Arts,Landscape Architecture,15,3,12
2004,Fine and Applied Arts,Landscape Architecture,26,7,19
2018,LAS,LAS - Undeclared,135,46,89
2017,LAS,LAS - Undeclared,116,38,78
2016,LAS,LAS - Undeclared,114,31,83
2015,LAS,LAS - Undeclared,135,40,95
2014,LAS,LAS - Undeclared,165,67,98
2013,LAS,LAS - Undeclared,154,53,101
2012,LAS,LAS - Undeclared,178,58,120
2011,LAS,LAS - Undeclared,177,69,108
2010,LAS,LAS - Undeclared,95,34,61
1984,LAS,LAS TCH MATH,3,1,2
1985,LAS,LAS TCH MATH,6,2,4
1986,LAS,LAS TCH MATH,10,5,5
1987,LAS,LAS TCH MATH,11,3,8
1988,LAS,LAS TCH MATH,12,3,9
1989,LAS,LAS TCH MATH,16,5,11
1990,LAS,LAS TCH MATH,13,3,10
1991,LAS,LAS TCH MATH,17,5,12
1992,LAS,LAS TCH MATH,13,6,7
1993,LAS,LAS TCH MATH,16,4,12
1994,LAS,LAS TCH MATH,11,4,7
1995,LAS,LAS TCH MATH,6,2,4
1996,LAS,LAS TCH MATH,3,1,2
1997,LAS,LAS TCH MATH,9,4,5
1998,LAS,LAS TCH MATH,6,3,3
1998,LAS,LATIN AMER ST,3,1,2
1999,LAS,LATIN AMER ST,4,1,3
2000,LAS,LATIN AMER ST,5,2,3
2001,LAS,LATIN AMER ST,7,3,4
2002,LAS,LATIN AMER ST,8,4,4
2003,LAS,LATIN AMER ST,3,1,2
2018,LAS,Latin American Studies,2,2,0
2018,LAS,Latin American Studies,3,2,1
2017,LAS,Latin American Studies,2,2,0
2017,LAS,Latin American Studies,1,1,0
2015,LAS,Latin American Studies,1,1,0
2015,LAS,Latin American Studies,2,1,1
2014,LAS,Latin American Studies,1,1,0
2014,LAS,Latin American Studies,2,1,1
2014,LAS,Latin American Studies,6,2,4
2013,LAS,Latin American Studies,4,1,3
2013,LAS,Latin American Studies,1,0,1
2013,LAS,Latin American Studies,7,1,6
2012,LAS,Latin American Studies,5,2,3
2012,LAS,Latin American Studies,1,1,0
2012,LAS,Latin American Studies,5,0,5
2011,LAS,Latin American Studies,1,1,0
2011,LAS,Latin American Studies,5,2,3
2011,LAS,Latin American Studies,6,3,3
2010,LAS,Latin American Studies,5,3,2
2010,LAS,Latin American Studies,6,3,3
2009,LAS,Latin American Studies,8,4,4
2009,LAS,Latin American Studies,9,5,4
2008,LAS,Latin American Studies,6,2,4
2008,LAS,Latin American Studies,9,3,6
2007,LAS,Latin American Studies,7,4,3
2007,LAS,Latin American Studies,7,2,5
2006,LAS,Latin American Studies,7,5,2
2006,LAS,Latin American Studies,3,0,3
2005,LAS,Latin American Studies,6,3,3
2005,LAS,Latin American Studies,8,2,6
2004,LAS,Latin American Studies,7,4,3
2004,LAS,Latin American Studies,8,3,5
2018,LAS,Latina/Latino Studies,15,1,14
2018,LAS,Latina/Latino Studies,1,0,1
2017,LAS,Latina/Latino Studies,10,1,9
2017,LAS,Latina/Latino Studies,3,0,3
2016,LAS,Latina/Latino Studies,11,3,8
2016,LAS,Latina/Latino Studies,3,0,3
2015,LAS,Latina/Latino Studies,2,1,1
2015,LAS,Latina/Latino Studies,2,1,1
2014,LAS,Latina/Latino Studies,4,0,4
2014,LAS,Latina/Latino Studies,1,1,0
2013,LAS,Latina/Latino Studies,3,2,1
2013,LAS,Latina/Latino Studies,2,1,1
2012,LAS,Latina/Latino Studies,6,2,4
2011,LAS,Latina/Latino Studies,8,3,5
2018,Law,Law,398,234,164
2018,Law,Law,8,3,5
2018,Law,Law,50,18,32
2018,Law,Law,1,0,1
2018,Law,Law,1,0,1
2018,Law,Law,1,1,0
2018,Law,Law,1,1,0
2018,Law,Law,4,4,0
2018,Law,Law,4,3,1
2018,Law,Law,19,5,14
2017,Law,Law,432,262,170
2017,Law,Law,7,2,5
2017,Law,Law,77,36,41
2017,Law,Law,1,0,1
2017,Law,Law,2,1,1
2017,Law,Law,26,17,9
2016,Law,Law,432,258,174
2016,Law,Law,10,3,7
2016,Law,Law,59,26,33
2016,Law,Law,4,0,4
2016,Law,Law,25,7,18
2015,Law,Law,2,0,2
2015,Law,Law,10,4,6
2015,Law,Law,21,15,6
2015,Law,Law,73,28,45
2015,Law,Law,474,285,189
2014,Law,Law,11,3,8
2014,Law,Law,15,4,11
2014,Law,Law,54,20,34
2014,Law,Law,502,290,212
2013,Law,Law,12,4,8
2013,Law,Law,105,30,75
2013,Law,Law,16,5,11
2013,Law,Law,537,299,238
2012,Law,Law,11,6,5
2012,Law,Law,119,39,80
2012,Law,Law,6,4,2
2012,Law,Law,616,349,267
2011,Law,Law,14,7,7
2011,Law,Law,5,1,4
2011,Law,Law,80,28,52
2011,Law,Law,630,366,264
2010,Law,Law,10,6,4
2010,Law,Law,83,23,60
2010,Law,Law,7,3,4
2010,Law,Law,635,371,264
2009,Law,Law,3,0,3
2009,Law,Law,7,4,3
2009,Law,Law,81,29,52
2009,Law,Law,616,357,259
2008,Law,Law,1,0,1
2008,Law,Law,6,4,2
2008,Law,Law,36,21,15
2008,Law,Law,581,325,256
2007,Law,Law,10,7,3
2007,Law,Law,43,17,26
2007,Law,Law,582,346,236
2006,Law,Law,1,0,1
2006,Law,Law,10,6,4
2006,Law,Law,26,12,14
2006,Law,Law,631,394,236
2005,Law,Law,1,0,1
2005,Law,Law,6,4,2
2005,Law,Law,36,13,23
2005,Law,Law,625,380,244
2004,Law,Law,671,387,282
2004,Law,Law,3,2,1
2004,Law,Law,32,15,17
2004,Law,Law,2,2,0
1980,Law,Law,24,19,5
1981,Law,Law,20,13,7
1982,Law,Law,21,18,3
1983,Law,Law,20,17,3
1984,Law,Law,25,20,5
1986,Law,Law,31,23,8
1987,Law,Law,23,16,7
1988,Law,Law,23,20,3
1989,Law,Law,19,15,4
1990,Law,Law,21,20,1
1991,Law,Law,9,7,2
1992,Law,Law,3,2,1
1993,Law,Law,3,2,1
1995,Law,Law,3,2,1
1997,Law,Law,3,2,1
1980,Law,Law,5,3,2
1980,Law,Law,610,446,164
1981,Law,Law,3,2,1
1981,Law,Law,622,436,186
1982,Law,Law,4,3,1
1982,Law,Law,633,429,204
1983,Law,Law,8,6,2
1983,Law,Law,647,426,221
1984,Law,Law,8,4,4
1984,Law,Law,630,408,222
1985,Law,Law,7,6,1
1985,Law,Law,625,404,221
1986,Law,Law,4,2,2
1986,Law,Law,628,402,226
1987,Law,Law,17,10,7
1987,Law,Law,605,368,237
1988,Law,Law,8,7,1
1988,Law,Law,588,351,237
1989,Law,Law,6,4,2
1989,Law,Law,587,345,242
1990,Law,Law,596,376,220
1991,Law,Law,25,18,7
1991,Law,Law,608,396,212
1992,Law,Law,23,17,6
1992,Law,Law,604,374,230
1993,Law,Law,25,20,5
1993,Law,Law,591,347,244
1994,Law,Law,25,17,8
1994,Law,Law,583,330,253
1995,Law,Law,18,13,5
1995,Law,Law,616,360,256
1996,Law,Law,18,11,7
1996,Law,Law,593,359,234
1997,Law,Law,21,15,6
1997,Law,Law,590,347,243
1998,Law,Law,25,18,7
1998,Law,Law,578,345,233
1999,Law,Law,38,20,18
1999,Law,Law,583,350,233
2000,Law,Law,32,21,11
2000,Law,Law,607,369,238
2001,Law,Law,35,23,12
2001,Law,Law,654,396,258
2002,Law,Law,37,19,18
2002,Law,Law,649,371,278
2003,Law,Law,32,17,15
2003,Law,Law,662,365,297
2018,Education,Learning and Education Studies,11,4,7
2018,Education,Learning and Education Studies,2,0,2
2018,Education,Learning and Education Studies,12,0,12
2018,Education,Learning and Education Studies,12,5,7
2018,Education,Learning and Education Studies,11,5,6
2017,Education,Learning and Education Studies,15,5,10
2017,Education,Learning and Education Studies,3,1,2
2017,Education,Learning and Education Studies,13,2,11
2017,Education,Learning and Education Studies,18,5,13
2017,Education,Learning and Education Studies,9,4,5
2016,Education,Learning and Education Studies,9,1,8
2016,Education,Learning and Education Studies,5,1,4
2016,Education,Learning and Education Studies,14,2,12
2016,Education,Learning and Education Studies,11,3,8
2016,Education,Learning and Education Studies,7,2,5
2015,Education,Learning and Education Studies,7,1,6
2015,Education,Learning and Education Studies,1,0,1
2015,Education,Learning and Education Studies,5,1,4
2015,Education,Learning and Education Studies,5,2,3
2015,Education,Learning and Education Studies,9,1,8
1980,Applied Health Sciences,Leisure Studies,51,28,23
1981,Applied Health Sciences,Leisure Studies,48,26,22
1982,Applied Health Sciences,Leisure Studies,47,23,24
1983,Applied Health Sciences,Leisure Studies,43,18,25
1984,Applied Health Sciences,Leisure Studies,45,19,26
1985,Applied Health Sciences,Leisure Studies,41,19,22
1986,Applied Health Sciences,Leisure Studies,39,14,25
1987,Applied Health Sciences,Leisure Studies,42,17,25
1988,Applied Health Sciences,Leisure Studies,44,21,23
1989,Applied Health Sciences,Leisure Studies,44,17,27
1990,Applied Health Sciences,Leisure Studies,45,20,25
1991,Applied Health Sciences,Leisure Studies,42,21,21
1992,Applied Health Sciences,Leisure Studies,43,21,22
1993,Applied Health Sciences,Leisure Studies,39,17,22
1993,Applied Health Sciences,Leisure Studies,60,34,26
1994,Applied Health Sciences,Leisure Studies,39,18,21
1994,Applied Health Sciences,Leisure Studies,118,55,63
1995,Applied Health Sciences,Leisure Studies,51,28,23
1995,Applied Health Sciences,Leisure Studies,178,80,98
1996,Applied Health Sciences,Leisure Studies,47,24,23
1996,Applied Health Sciences,Leisure Studies,187,83,104
1997,Applied Health Sciences,Leisure Studies,38,23,15
1997,Applied Health Sciences,Leisure Studies,77,39,38
1998,Applied Health Sciences,Leisure Studies,68,38,30
1998,Applied Health Sciences,Leisure Studies,47,26,21
1999,Applied Health Sciences,Leisure Studies,41,20,21
1999,Applied Health Sciences,Leisure Studies,74,46,28
2000,Applied Health Sciences,Leisure Studies,37,23,14
2000,Applied Health Sciences,Leisure Studies,100,65,35
2001,Applied Health Sciences,Leisure Studies,61,40,21
2001,Applied Health Sciences,Leisure Studies,112,83,29
2002,Applied Health Sciences,Leisure Studies,75,47,28
2002,Applied Health Sciences,Leisure Studies,92,70,22
2003,Applied Health Sciences,Leisure Studies,65,34,31
2003,Applied Health Sciences,Leisure Studies,103,72,31
2009,Applied Health Sciences,Leisure Studies,1,1,0
2009,Applied Health Sciences,Leisure Studies,1,0,1
2009,Applied Health Sciences,Leisure Studies,1,1,0
2008,Applied Health Sciences,Leisure Studies,1,0,1
2008,Applied Health Sciences,Leisure Studies,5,4,1
2007,Applied Health Sciences,Leisure Studies,2,2,0
2007,Applied Health Sciences,Leisure Studies,2,0,2
2007,Applied Health Sciences,Leisure Studies,2,0,2
2007,Applied Health Sciences,Leisure Studies,11,9,2
2006,Applied Health Sciences,Leisure Studies,3,2,1
2006,Applied Health Sciences,Leisure Studies,21,13,8
2006,Applied Health Sciences,Leisure Studies,2,1,1
2006,Applied Health Sciences,Leisure Studies,19,6,13
2006,Applied Health Sciences,Leisure Studies,15,6,9
2006,Applied Health Sciences,Leisure Studies,89,68,21
2005,Applied Health Sciences,Leisure Studies,1,1,0
2005,Applied Health Sciences,Leisure Studies,1,0,1
2005,Applied Health Sciences,Leisure Studies,39,14,25
2005,Applied Health Sciences,Leisure Studies,40,9,31
2005,Applied Health Sciences,Leisure Studies,17,8,9
2005,Applied Health Sciences,Leisure Studies,22,10,12
2005,Applied Health Sciences,Leisure Studies,133,87,46
2005,Applied Health Sciences,Leisure Studies,167,129,37
2004,Applied Health Sciences,Leisure Studies,155,107,47
2004,Applied Health Sciences,Leisure Studies,21,8,13
2004,Applied Health Sciences,Leisure Studies,31,5,26
2004,Applied Health Sciences,Leisure Studies,2,0,2
2004,Applied Health Sciences,Leisure Studies,142,108,34
2004,Applied Health Sciences,Leisure Studies,42,22,20
2004,Applied Health Sciences,Leisure Studies,12,4,8
1980,iSchool,Library & Information Science,142,34,108
1981,iSchool,Library & Information Science,148,34,114
1982,iSchool,Library & Information Science,155,38,117
1983,iSchool,Library & Information Science,183,45,138
1984,iSchool,Library & Information Science,184,47,137
1985,iSchool,Library & Information Science,173,47,126
1986,iSchool,Library & Information Science,206,58,148
1987,iSchool,Library & Information Science,190,42,148
1988,iSchool,Library & Information Science,178,51,127
1989,iSchool,Library & Information Science,180,57,123
1990,iSchool,Library & Information Science,202,65,137
1991,iSchool,Library & Information Science,235,70,165
1992,iSchool,Library & Information Science,225,59,166
1993,iSchool,Library & Information Science,257,76,181
1994,iSchool,Library & Information Science,271,91,180
1995,iSchool,Library & Information Science,235,76,159
1996,iSchool,Library & Information Science,240,84,156
1997,iSchool,Library & Information Science,96,27,69
1998,iSchool,Library & Information Science,6,1,5
1997,iSchool,Library & Information Science,87,31,56
1998,iSchool,Library & Information Science,177,54,123
1999,iSchool,Library & Information Science,177,58,119
2000,iSchool,Library & Information Science,196,57,139
2001,iSchool,Library & Information Science,217,53,164
2002,iSchool,Library & Information Science,230,61,169
2003,iSchool,Library & Information Science,195,66,129
1997,iSchool,Library & Information Science,9,2,7
1998,iSchool,Library & Information Science,7,1,6
2000,iSchool,Library & Information Science,4,1,3
2001,iSchool,Library & Information Science,3,1,2
2002,iSchool,Library & Information Science,8,2,6
1997,iSchool,Library & Information Science,25,6,19
1998,iSchool,Library & Information Science,28,5,23
1999,iSchool,Library & Information Science,45,11,34
2000,iSchool,Library & Information Science,57,11,46
2001,iSchool,Library & Information Science,66,13,53
2002,iSchool,Library & Information Science,54,13,41
2003,iSchool,Library & Information Science,53,14,39
1997,iSchool,Library & Information Science,17,11,6
1998,iSchool,Library & Information Science,24,11,13
1999,iSchool,Library & Information Science,29,12,17
2000,iSchool,Library & Information Science,32,9,23
2001,iSchool,Library & Information Science,38,12,26
2002,iSchool,Library & Information Science,40,10,30
2003,iSchool,Library & Information Science,47,17,30
2002,iSchool,Library & Information Science,4,1,3
2003,iSchool,Library & Information Science,13,1,12
2003,iSchool,Library & Information Science,2,1,1
2018,iSchool,Library & Information Science,5,0,5
2018,iSchool,Library & Information Science,7,1,6
2018,iSchool,Library & Information Science,202,48,153
2018,iSchool,Library & Information Science,264,50,210
2018,iSchool,Library & Information Science,51,17,34
2017,iSchool,Library & Information Science,6,0,6
2017,iSchool,Library & Information Science,5,0,5
2017,iSchool,Library & Information Science,208,47,161
2017,iSchool,Library & Information Science,284,60,220
2017,iSchool,Library & Information Science,49,14,35
2016,iSchool,Library & Information Science,5,2,3
2016,iSchool,Library & Information Science,195,43,151
2016,iSchool,Library & Information Science,11,3,8
2016,iSchool,Library & Information Science,1,0,1
2016,iSchool,Library & Information Science,50,13,37
2015,iSchool,Library & Information Science,1,0,1
2015,iSchool,Library & Information Science,6,2,4
2015,iSchool,Library & Information Science,11,1,10
2015,iSchool,Library & Information Science,56,19,37
2015,iSchool,Library & Information Science,194,51,143
2014,iSchool,Library & Information Science,2,0,2
2014,iSchool,Library & Information Science,9,1,8
2014,iSchool,Library & Information Science,7,1,6
2014,iSchool,Library & Information Science,61,20,41
2014,iSchool,Library & Information Science,202,53,149
2013,iSchool,Library & Information Science,7,2,5
2013,iSchool,Library & Information Science,11,1,10
2013,iSchool,Library & Information Science,57,21,36
2013,iSchool,Library & Information Science,216,54,162
2012,iSchool,Library & Information Science,1,0,1
2012,iSchool,Library & Information Science,11,1,10
2012,iSchool,Library & Information Science,8,1,7
2012,iSchool,Library & Information Science,49,22,27
2012,iSchool,Library & Information Science,244,64,180
2011,iSchool,Library & Information Science,13,2,11
2011,iSchool,Library & Information Science,1,0,1
2011,iSchool,Library & Information Science,10,3,7
2011,iSchool,Library & Information Science,47,18,29
2011,iSchool,Library & Information Science,246,66,180
2010,iSchool,Library & Information Science,4,1,3
2010,iSchool,Library & Information Science,1,0,1
2010,iSchool,Library & Information Science,22,5,17
2010,iSchool,Library & Information Science,51,20,31
2010,iSchool,Library & Information Science,249,65,183
2009,iSchool,Library & Information Science,4,0,4
2009,iSchool,Library & Information Science,1,0,1
2009,iSchool,Library & Information Science,5,1,4
2009,iSchool,Library & Information Science,20,4,16
2009,iSchool,Library & Information Science,43,11,32
2009,iSchool,Library & Information Science,224,68,156
2008,iSchool,Library & Information Science,1,0,1
2008,iSchool,Library & Information Science,2,0,2
2008,iSchool,Library & Information Science,2,0,2
2008,iSchool,Library & Information Science,21,7,14
2008,iSchool,Library & Information Science,45,17,28
2008,iSchool,Library & Information Science,215,54,161
2007,iSchool,Library & Information Science,10,4,6
2007,iSchool,Library & Information Science,4,0,4
2007,iSchool,Library & Information Science,8,0,8
2007,iSchool,Library & Information Science,7,2,5
2007,iSchool,Library & Information Science,1,0,1
2007,iSchool,Library & Information Science,42,16,26
2007,iSchool,Library & Information Science,178,37,141
2006,iSchool,Library & Information Science,7,2,5
2006,iSchool,Library & Information Science,1,0,1
2006,iSchool,Library & Information Science,5,0,5
2006,iSchool,Library & Information Science,2,0,2
2006,iSchool,Library & Information Science,15,2,13
2006,iSchool,Library & Information Science,50,18,32
2006,iSchool,Library & Information Science,186,50,136
2005,iSchool,Library & Information Science,2,1,1
2005,iSchool,Library & Information Science,9,0,9
2005,iSchool,Library & Information Science,5,0,5
2005,iSchool,Library & Information Science,13,1,12
2005,iSchool,Library & Information Science,48,17,31
2005,iSchool,Library & Information Science,170,49,121
2004,iSchool,Library & Information Science,6,2,4
2004,iSchool,Library & Information Science,161,52,109
2004,iSchool,Library & Information Science,3,0,3
2004,iSchool,Library & Information Science,39,7,32
2004,iSchool,Library & Information Science,7,2,5
2004,iSchool,Library & Information Science,6,1,5
2004,iSchool,Library & Information Science,45,15,30
2018,LAS,Linguistics,79,38,41
2018,LAS,Linguistics,4,0,4
2018,LAS,Linguistics,14,4,10
2018,LAS,Linguistics,26,7,19
2018,LAS,Linguistics,2,1,1
2017,LAS,Linguistics,78,28,50
2017,LAS,Linguistics,4,1,3
2017,LAS,Linguistics,19,3,16
2017,LAS,Linguistics,1,1,0
2017,LAS,Linguistics,32,8,24
2017,LAS,Linguistics,1,1,0
2016,LAS,Linguistics,73,27,46
2016,LAS,Linguistics,4,1,3
2016,LAS,Linguistics,14,2,12
2016,LAS,Linguistics,1,0,1
2016,LAS,Linguistics,1,0,1
2016,LAS,Linguistics,30,9,21
2016,LAS,Linguistics,1,1,0
2015,LAS,Linguistics,4,0,4
2015,LAS,Linguistics,2,0,2
2015,LAS,Linguistics,1,1,0
2015,LAS,Linguistics,67,25,42
2015,LAS,Linguistics,13,4,9
2015,LAS,Linguistics,27,8,19
2014,LAS,Linguistics,1,0,1
2014,LAS,Linguistics,3,0,3
2014,LAS,Linguistics,1,1,0
2014,LAS,Linguistics,63,23,40
2014,LAS,Linguistics,14,5,9
2014,LAS,Linguistics,29,9,20
2013,LAS,Linguistics,5,0,5
2013,LAS,Linguistics,17,6,11
2013,LAS,Linguistics,1,0,1
2013,LAS,Linguistics,28,11,17
2013,LAS,Linguistics,53,19,34
2012,LAS,Linguistics,1,0,1
2012,LAS,Linguistics,20,7,13
2012,LAS,Linguistics,2,1,1
2012,LAS,Linguistics,32,11,21
2012,LAS,Linguistics,50,16,34
2011,LAS,Linguistics,1,0,1
2011,LAS,Linguistics,2,1,1
2011,LAS,Linguistics,22,7,15
2011,LAS,Linguistics,1,0,1
2011,LAS,Linguistics,31,12,19
2011,LAS,Linguistics,46,21,25
2010,LAS,Linguistics,32,11,21
2010,LAS,Linguistics,1,0,1
2010,LAS,Linguistics,7,5,2
2010,LAS,Linguistics,21,9,12
2010,LAS,Linguistics,1,0,1
2010,LAS,Linguistics,39,12,27
2009,LAS,Linguistics,2,0,2
2009,LAS,Linguistics,8,5,3
2009,LAS,Linguistics,1,0,1
2009,LAS,Linguistics,38,15,23
2009,LAS,Linguistics,19,10,9
2009,LAS,Linguistics,41,11,30
2008,LAS,Linguistics,2,1,1
2008,LAS,Linguistics,1,0,1
2008,LAS,Linguistics,65,25,40
2008,LAS,Linguistics,14,8,6
2008,LAS,Linguistics,42,14,28
2007,LAS,Linguistics,3,1,2
2007,LAS,Linguistics,74,31,43
2007,LAS,Linguistics,12,6,6
2007,LAS,Linguistics,50,15,35
2006,LAS,Linguistics,2,2,0
2006,LAS,Linguistics,59,27,32
2006,LAS,Linguistics,11,2,9
2006,LAS,Linguistics,52,18,34
2005,LAS,Linguistics,43,20,23
2005,LAS,Linguistics,12,2,10
2005,LAS,Linguistics,48,20,28
2004,LAS,Linguistics,35,17,18
2004,LAS,Linguistics,9,1,8
2004,LAS,Linguistics,53,19,34
1980,LAS,Linguistics,63,32,31
1981,LAS,Linguistics,73,41,32
1982,LAS,Linguistics,74,33,41
1983,LAS,Linguistics,82,34,48
1984,LAS,Linguistics,76,36,40
1985,LAS,Linguistics,72,37,35
1986,LAS,Linguistics,79,39,40
1987,LAS,Linguistics,89,43,46
1988,LAS,Linguistics,87,41,46
1989,LAS,Linguistics,91,43,48
1990,LAS,Linguistics,94,42,52
1991,LAS,Linguistics,99,44,55
1992,LAS,Linguistics,93,42,51
1993,LAS,Linguistics,88,40,48
1994,LAS,Linguistics,84,38,46
1995,LAS,Linguistics,81,30,51
1996,LAS,Linguistics,68,23,45
1997,LAS,Linguistics,55,16,39
1998,LAS,Linguistics,55,17,38
1999,LAS,Linguistics,49,18,31
2000,LAS,Linguistics,70,26,44
2001,LAS,Linguistics,74,26,48
2002,LAS,Linguistics,67,24,43
2003,LAS,Linguistics,71,25,46
2018,Fine and Applied Arts,Lyric Theatre,12,2,10
1989,Business,MANAGEMENT,14,7,7
1990,Business,MANAGEMENT,15,12,3
2018,Business,Management,23,16,7
2018,Business,Management,5,3,2
2018,Business,Management,11,3,8
2018,Business,Management,7,2,5
2018,Business,Management,33,16,17
2018,Business,Management,13,6,7
2018,Business,Management,15,6,9
2017,Business,Management,30,20,10
2017,Business,Management,6,4,2
2017,Business,Management,17,9,8
2017,Business,Management,12,2,10
2017,Business,Management,36,19,17
2017,Business,Management,17,8,9
2016,Business,Management,1,0,1
2016,Business,Management,20,9,11
2016,Business,Management,5,0,5
2016,Business,Management,18,5,13
2016,Business,Management,18,2,16
2016,Business,Management,32,12,20
2016,Business,Management,14,7,7
2015,Business,Management,3,1,2
2015,Business,Management,12,5,7
2015,Business,Management,14,2,12
2015,Business,Management,19,3,16
2015,Business,Management,33,18,15
2015,Business,Management,19,9,10
2014,Business,Management,12,3,9
2014,Business,Management,3,0,3
2014,Business,Management,15,4,11
2014,Business,Management,20,7,13
2014,Business,Management,30,19,11
2014,Business,Management,23,12,11
2013,Business,Management,30,17,13
2013,Business,Management,1,0,1
2013,Business,Management,18,8,10
2013,Business,Management,17,8,9
2013,Business,Management,3,0,3
2013,Business,Management,20,8,12
2013,Business,Management,20,6,14
2012,Business,Management,29,12,17
2012,Business,Management,14,4,10
2012,Business,Management,16,9,7
2012,Business,Management,5,1,4
2012,Business,Management,35,20,15
2012,Business,Management,12,4,8
2011,Business,Management,1,1,0
2011,Business,Management,25,17,8
2011,Business,Management,13,4,9
2011,Business,Management,8,4,4
2011,Business,Management,37,20,17
2011,Business,Management,14,1,13
2011,Business,Management,52,30,22
2010,Business,Management,2,2,0
2010,Business,Management,11,5,6
2010,Business,Management,47,20,27
2010,Business,Management,27,20,7
2010,Business,Management,20,3,17
2010,Business,Management,56,32,23
2010,Business,Management,18,9,9
2009,Business,Management,11,2,9
2009,Business,Management,8,4,4
2009,Business,Management,10,5,5
2009,Business,Management,54,23,30
2009,Business,Management,29,17,12
2009,Business,Management,52,17,35
2008,Business,Management,3,1,2
2008,Business,Management,11,7,4
2008,Business,Management,6,2,4
2008,Business,Management,6,3,3
2008,Business,Management,31,17,14
2008,Business,Management,27,11,16
2007,Business,Management,1,0,1
1981,Business,MARKETING,186,85,101
1982,Business,MARKETING,223,102,121
1983,Business,MARKETING,196,85,111
1980,Business,MARKETING,54,24,30
1984,Business,MARKETING,179,73,106
1985,Business,MARKETING,218,76,142
1986,Business,MARKETING,228,72,156
1987,Business,MARKETING,201,64,137
1988,Business,MARKETING,168,60,108
1989,Business,MARKETING,164,69,95
1990,Business,MARKETING,145,61,84
1991,Business,MARKETING,178,80,98
1992,Business,MARKETING,25,11,14
2018,Business,Marketing,106,30,76
2018,Business,Marketing,134,44,90
2017,Business,Marketing,119,43,76
2017,Business,Marketing,130,44,86
2016,Business,Marketing,112,42,70
2016,Business,Marketing,118,46,72
2015,Business,Marketing,114,44,70
2015,Business,Marketing,107,47,60
2014,Business,Marketing,98,28,70
2014,Business,Marketing,123,45,78
2013,Business,Marketing,116,39,77
2013,Business,Marketing,91,31,60
2012,Business,Marketing,105,33,72
2012,Business,Marketing,93,39,54
2011,Business,Marketing,102,32,70
2011,Business,Marketing,103,40,63
2010,Business,Marketing,89,26,63
2010,Business,Marketing,112,42,70
2009,Business,Marketing,47,14,33
2009,Business,Marketing,104,44,60
2008,Business,Marketing,27,7,20
2008,Business,Marketing,75,32,43
2007,Business,Marketing,3,1,2
1994,Engineering,Materials Science & Engr,121,96,25
1995,Engineering,Materials Science & Engr,130,102,28
1996,Engineering,Materials Science & Engr,111,90,21
1997,Engineering,Materials Science & Engr,113,86,27
1998,Engineering,Materials Science & Engr,107,77,30
1999,Engineering,Materials Science & Engr,105,76,29
2000,Engineering,Materials Science & Engr,115,84,31
2001,Engineering,Materials Science & Engr,135,100,35
2002,Engineering,Materials Science & Engr,142,106,36
2003,Engineering,Materials Science & Engr,158,108,50
2018,Engineering,Materials Science & Engr,249,175,74
2018,Engineering,Materials Science & Engr,7,6,1
2018,Engineering,Materials Science & Engr,20,18,2
2018,Engineering,Materials Science & Engr,14,6,8
2018,Engineering,Materials Science & Engr,14,10,4
2018,Engineering,Materials Science & Engr,21,18,3
2018,Engineering,Materials Science & Engr,28,20,8
2018,Engineering,Materials Science & Engr,149,102,47
2018,Engineering,Materials Science & Engr,2,2,0
2017,Engineering,Materials Science & Engr,268,193,75
2017,Engineering,Materials Science & Engr,5,5,0
2017,Engineering,Materials Science & Engr,22,18,4
2017,Engineering,Materials Science & Engr,16,11,5
2017,Engineering,Materials Science & Engr,15,8,7
2017,Engineering,Materials Science & Engr,14,7,7
2017,Engineering,Materials Science & Engr,31,26,5
2017,Engineering,Materials Science & Engr,1,1,0
2017,Engineering,Materials Science & Engr,145,99,46
2017,Engineering,Materials Science & Engr,3,1,2
2016,Engineering,Materials Science & Engr,271,197,74
2016,Engineering,Materials Science & Engr,3,3,0
2016,Engineering,Materials Science & Engr,37,24,13
2016,Engineering,Materials Science & Engr,9,9,0
2016,Engineering,Materials Science & Engr,15,8,7
2016,Engineering,Materials Science & Engr,33,16,17
2016,Engineering,Materials Science & Engr,40,33,7
2016,Engineering,Materials Science & Engr,1,1,0
2016,Engineering,Materials Science & Engr,156,106,50
2016,Engineering,Materials Science & Engr,1,0,1
2015,Engineering,Materials Science & Engr,2,2,0
2015,Engineering,Materials Science & Engr,4,3,1
2015,Engineering,Materials Science & Engr,9,5,4
2015,Engineering,Materials Science & Engr,24,18,6
2015,Engineering,Materials Science & Engr,20,16,4
2015,Engineering,Materials Science & Engr,44,24,20
2015,Engineering,Materials Science & Engr,42,28,14
2015,Engineering,Materials Science & Engr,147,109,38
2015,Engineering,Materials Science & Engr,294,213,81
2014,Engineering,Materials Science & Engr,2,2,0
2014,Engineering,Materials Science & Engr,8,5,3
2014,Engineering,Materials Science & Engr,13,9,4
2014,Engineering,Materials Science & Engr,14,13,1
2014,Engineering,Materials Science & Engr,20,11,9
2014,Engineering,Materials Science & Engr,22,18,4
2014,Engineering,Materials Science & Engr,36,24,12
2014,Engineering,Materials Science & Engr,332,240,92
2014,Engineering,Materials Science & Engr,153,113,40
2013,Engineering,Materials Science & Engr,7,6,1
2013,Engineering,Materials Science & Engr,27,22,5
2013,Engineering,Materials Science & Engr,18,17,1
2013,Engineering,Materials Science & Engr,26,19,7
2013,Engineering,Materials Science & Engr,20,10,10
2013,Engineering,Materials Science & Engr,34,25,9
2013,Engineering,Materials Science & Engr,158,112,46
2013,Engineering,Materials Science & Engr,312,242,70
2012,Engineering,Materials Science & Engr,4,4,0
2012,Engineering,Materials Science & Engr,18,12,6
2012,Engineering,Materials Science & Engr,17,14,3
2012,Engineering,Materials Science & Engr,14,8,6
2012,Engineering,Materials Science & Engr,1,1,0
2012,Engineering,Materials Science & Engr,20,17,3
2012,Engineering,Materials Science & Engr,1,1,0
2012,Engineering,Materials Science & Engr,31,19,12
2012,Engineering,Materials Science & Engr,166,124,42
2012,Engineering,Materials Science & Engr,299,233,66
2011,Engineering,Materials Science & Engr,9,7,2
2011,Engineering,Materials Science & Engr,14,11,3
2011,Engineering,Materials Science & Engr,15,12,3
2011,Engineering,Materials Science & Engr,4,3,1
2011,Engineering,Materials Science & Engr,149,114,35
2011,Engineering,Materials Science & Engr,10,8,2
2011,Engineering,Materials Science & Engr,9,6,3
2011,Engineering,Materials Science & Engr,15,11,4
2011,Engineering,Materials Science & Engr,322,251,71
2010,Engineering,Materials Science & Engr,5,3,2
2010,Engineering,Materials Science & Engr,5,5,0
2010,Engineering,Materials Science & Engr,14,10,4
2010,Engineering,Materials Science & Engr,9,5,4
2010,Engineering,Materials Science & Engr,13,12,1
2010,Engineering,Materials Science & Engr,1,0,1
2010,Engineering,Materials Science & Engr,143,109,34
2010,Engineering,Materials Science & Engr,8,6,2
2010,Engineering,Materials Science & Engr,268,210,58
2009,Engineering,Materials Science & Engr,1,1,0
2009,Engineering,Materials Science & Engr,6,4,2
2009,Engineering,Materials Science & Engr,7,6,1
2009,Engineering,Materials Science & Engr,14,10,4
2009,Engineering,Materials Science & Engr,13,9,4
2009,Engineering,Materials Science & Engr,18,12,6
2009,Engineering,Materials Science & Engr,14,11,3
2009,Engineering,Materials Science & Engr,247,184,63
2009,Engineering,Materials Science & Engr,143,107,36
2008,Engineering,Materials Science & Engr,3,2,1
2008,Engineering,Materials Science & Engr,5,4,1
2008,Engineering,Materials Science & Engr,13,10,3
2008,Engineering,Materials Science & Engr,1,1,0
2008,Engineering,Materials Science & Engr,4,4,0
2008,Engineering,Materials Science & Engr,8,8,0
2008,Engineering,Materials Science & Engr,11,7,4
2008,Engineering,Materials Science & Engr,242,190,52
2008,Engineering,Materials Science & Engr,152,113,39
2007,Engineering,Materials Science & Engr,1,1,0
2007,Engineering,Materials Science & Engr,4,2,2
2007,Engineering,Materials Science & Engr,238,185,53
2007,Engineering,Materials Science & Engr,155,117,38
2006,Engineering,Materials Science & Engr,1,1,0
2006,Engineering,Materials Science & Engr,10,7,3
2006,Engineering,Materials Science & Engr,230,174,56
2006,Engineering,Materials Science & Engr,162,118,44
2005,Engineering,Materials Science & Engr,3,3,0
2005,Engineering,Materials Science & Engr,8,6,2
2005,Engineering,Materials Science & Engr,212,165,47
2005,Engineering,Materials Science & Engr,160,114,46
2004,Engineering,Materials Science & Engr,225,170,55
2004,Engineering,Materials Science & Engr,10,5,5
2004,Engineering,Materials Science & Engr,3,3,0
2004,Engineering,Materials Science & Engr,170,122,48
2018,LAS,Math & Computer Science,264,218,46
2018,LAS,Math & Computer Science,9,7,2
2017,LAS,Math & Computer Science,302,247,54
2017,LAS,Math & Computer Science,4,1,3
2016,LAS,Math & Computer Science,300,248,52
2016,LAS,Math & Computer Science,5,3,2
2015,LAS,Math & Computer Science,9,6,3
2015,LAS,Math & Computer Science,254,210,44
2014,LAS,Math & Computer Science,5,4,1
2014,LAS,Math & Computer Science,205,170,35
2013,LAS,Math & Computer Science,1,0,1
2013,LAS,Math & Computer Science,160,132,28
2012,LAS,Math & Computer Science,2,1,1
2012,LAS,Math & Computer Science,84,70,14
2011,LAS,Math & Computer Science,1,1,0
2011,LAS,Math & Computer Science,71,63,8
2010,LAS,Math & Computer Science,82,72,10
2009,LAS,Math & Computer Science,79,68,11
2008,LAS,Math & Computer Science,92,84,8
2007,LAS,Math & Computer Science,106,99,7
2006,LAS,Math & Computer Science,120,111,8
2005,LAS,Math & Computer Science,3,3,0
2005,LAS,Math & Computer Science,125,114,10
2004,LAS,Math & Computer Science,159,138,20
2018,LAS,Mathematics,1,1,0
2018,LAS,Mathematics,40,29,11
2018,LAS,Mathematics,74,35,39
2018,LAS,Mathematics,1,1,0
2018,LAS,Mathematics,15,10,5
2018,LAS,Mathematics,7,3,4
2018,LAS,Mathematics,1,1,0
2018,LAS,Mathematics,17,8,9
2018,LAS,Mathematics,1,1,0
2018,LAS,Mathematics,13,11,2
2018,LAS,Mathematics,464,319,144
2018,LAS,Mathematics,134,85,49
2018,LAS,Mathematics,2,1,1
2018,LAS,Mathematics,2,1,1
2017,LAS,Mathematics,29,23,6
2017,LAS,Mathematics,59,29,30
2017,LAS,Mathematics,5,4,1
2017,LAS,Mathematics,2,1,1
2017,LAS,Mathematics,12,7,5
2017,LAS,Mathematics,8,6,2
2017,LAS,Mathematics,4,4,0
2017,LAS,Mathematics,2,2,0
2017,LAS,Mathematics,12,5,7
2017,LAS,Mathematics,15,11,4
2017,LAS,Mathematics,446,271,174
2017,LAS,Mathematics,149,94,55
2017,LAS,Mathematics,1,1,0
2016,LAS,Mathematics,29,24,5
2016,LAS,Mathematics,56,35,21
2016,LAS,Mathematics,4,1,3
2016,LAS,Mathematics,5,3,2
2016,LAS,Mathematics,14,7,7
2016,LAS,Mathematics,13,7,6
2016,LAS,Mathematics,2,2,0
2016,LAS,Mathematics,1,0,1
2016,LAS,Mathematics,19,8,11
2016,LAS,Mathematics,17,11,6
2016,LAS,Mathematics,462,288,174
2016,LAS,Mathematics,162,99,63
2015,LAS,Mathematics,1,1,0
2015,LAS,Mathematics,3,2,1
2015,LAS,Mathematics,1,1,0
2015,LAS,Mathematics,38,15,23
2015,LAS,Mathematics,5,5,0
2015,LAS,Mathematics,17,9,8
2015,LAS,Mathematics,20,16,4
2015,LAS,Mathematics,19,12,7
2015,LAS,Mathematics,32,24,8
2015,LAS,Mathematics,36,17,19
2015,LAS,Mathematics,162,98,64
2015,LAS,Mathematics,425,265,160
2014,LAS,Mathematics,31,15,16
2014,LAS,Mathematics,1,1,0
2014,LAS,Mathematics,1,0,1
2014,LAS,Mathematics,3,2,1
2014,LAS,Mathematics,6,6,0
2014,LAS,Mathematics,6,4,2
2014,LAS,Mathematics,8,6,2
2014,LAS,Mathematics,11,6,5
2014,LAS,Mathematics,28,20,8
2014,LAS,Mathematics,25,19,6
2014,LAS,Mathematics,29,20,9
2014,LAS,Mathematics,160,100,60
2014,LAS,Mathematics,390,249,141
2013,LAS,Mathematics,1,1,0
2013,LAS,Mathematics,45,32,13
2013,LAS,Mathematics,23,10,13
2013,LAS,Mathematics,2,2,0
2013,LAS,Mathematics,3,2,1
2013,LAS,Mathematics,15,9,6
2013,LAS,Mathematics,8,6,2
2013,LAS,Mathematics,6,6,0
2013,LAS,Mathematics,2,1,1
2013,LAS,Mathematics,38,15,23
2013,LAS,Mathematics,1,1,0
2013,LAS,Mathematics,8,3,5
2013,LAS,Mathematics,169,111,58
2013,LAS,Mathematics,376,240,136
2012,LAS,Mathematics,33,22,11
2012,LAS,Mathematics,3,3,0
2012,LAS,Mathematics,1,0,1
2012,LAS,Mathematics,10,7,3
2012,LAS,Mathematics,4,2,2
2012,LAS,Mathematics,3,3,0
2012,LAS,Mathematics,1,0,1
2012,LAS,Mathematics,52,12,40
2012,LAS,Mathematics,1,1,0
2012,LAS,Mathematics,12,6,6
2012,LAS,Mathematics,1,1,0
2012,LAS,Mathematics,1,0,1
2012,LAS,Mathematics,157,103,54
2012,LAS,Mathematics,12,4,8
2012,LAS,Mathematics,322,225,97
2011,LAS,Mathematics,4,3,1
2011,LAS,Mathematics,2,2,0
2011,LAS,Mathematics,11,7,4
2011,LAS,Mathematics,2,1,1
2011,LAS,Mathematics,4,1,3
2011,LAS,Mathematics,70,26,44
2011,LAS,Mathematics,17,12,5
2011,LAS,Mathematics,1,1,0
2011,LAS,Mathematics,151,101,50
2011,LAS,Mathematics,32,19,13
2011,LAS,Mathematics,350,217,133
2010,LAS,Mathematics,28,17,11
2010,LAS,Mathematics,4,3,1
2010,LAS,Mathematics,1,1,0
2010,LAS,Mathematics,7,6,1
2010,LAS,Mathematics,66,32,34
2010,LAS,Mathematics,1,0,1
2010,LAS,Mathematics,11,10,1
2010,LAS,Mathematics,1,1,0
2010,LAS,Mathematics,155,112,43
2010,LAS,Mathematics,5,3,2
2010,LAS,Mathematics,314,176,138
2009,LAS,Mathematics,4,4,0
2009,LAS,Mathematics,6,2,4
2009,LAS,Mathematics,2,1,1
2009,LAS,Mathematics,5,5,0
2009,LAS,Mathematics,3,2,1
2009,LAS,Mathematics,61,23,38
2009,LAS,Mathematics,8,6,2
2009,LAS,Mathematics,53,36,17
2009,LAS,Mathematics,270,148,122
2009,LAS,Mathematics,155,123,32
2008,LAS,Mathematics,2,1,1
2008,LAS,Mathematics,1,1,0
2008,LAS,Mathematics,5,3,2
2008,LAS,Mathematics,1,1,0
2008,LAS,Mathematics,1,0,1
2008,LAS,Mathematics,2,2,0
2008,LAS,Mathematics,4,4,0
2008,LAS,Mathematics,65,23,42
2008,LAS,Mathematics,11,9,2
2008,LAS,Mathematics,136,82,53
2008,LAS,Mathematics,178,110,68
2008,LAS,Mathematics,152,115,37
2007,LAS,Mathematics,2,2,0
2007,LAS,Mathematics,1,1,0
2007,LAS,Mathematics,2,2,0
2007,LAS,Mathematics,40,26,14
2007,LAS,Mathematics,2,1,1
2007,LAS,Mathematics,1,1,0
2007,LAS,Mathematics,60,18,42
2007,LAS,Mathematics,6,5,1
2007,LAS,Mathematics,284,155,129
2007,LAS,Mathematics,153,114,39
2006,LAS,Mathematics,1,1,0
2006,LAS,Mathematics,1,0,1
2006,LAS,Mathematics,3,2,1
2006,LAS,Mathematics,1,0,1
2006,LAS,Mathematics,1,1,0
2006,LAS,Mathematics,39,26,13
2006,LAS,Mathematics,57,23,34
2006,LAS,Mathematics,5,5,0
2006,LAS,Mathematics,11,8,3
2006,LAS,Mathematics,300,167,133
2006,LAS,Mathematics,171,135,36
2005,LAS,Mathematics,1,0,1
2005,LAS,Mathematics,1,1,0
2005,LAS,Mathematics,4,4,0
2005,LAS,Mathematics,5,4,1
2005,LAS,Mathematics,3,2,1
2005,LAS,Mathematics,3,3,0
2005,LAS,Mathematics,62,37,25
2005,LAS,Mathematics,61,23,38
2005,LAS,Mathematics,11,9,2
2005,LAS,Mathematics,279,167,112
2005,LAS,Mathematics,183,144,39
2004,LAS,Mathematics,226,127,99
2004,LAS,Mathematics,1,1,0
2004,LAS,Mathematics,4,3,1
2004,LAS,Mathematics,8,7,1
2004,LAS,Mathematics,28,13,15
2004,LAS,Mathematics,13,10,3
2004,LAS,Mathematics,4,2,2
2004,LAS,Mathematics,166,99,67
2004,LAS,Mathematics,174,140,34
1980,LAS,Mathematics,139,119,20
1981,LAS,Mathematics,151,123,28
1982,LAS,Mathematics,159,124,35
1983,LAS,Mathematics,181,142,39
1984,LAS,Mathematics,181,135,46
1985,LAS,Mathematics,184,135,49
1986,LAS,Mathematics,167,127,40
1987,LAS,Mathematics,163,116,47
1988,LAS,Mathematics,173,131,42
1989,LAS,Mathematics,208,160,48
1990,LAS,Mathematics,204,161,43
1991,LAS,Mathematics,205,158,47
1992,LAS,Mathematics,194,148,46
1993,LAS,Mathematics,193,148,45
1994,LAS,Mathematics,188,146,42
1995,LAS,Mathematics,196,148,48
1996,LAS,Mathematics,195,149,46
1997,LAS,Mathematics,168,129,39
1998,LAS,Mathematics,155,116,39
1999,LAS,Mathematics,171,121,50
2000,LAS,Mathematics,173,122,51
2001,LAS,Mathematics,167,125,42
2002,LAS,Mathematics,175,137,38
2003,LAS,Mathematics,165,130,35
1995,Engineering,MATSCI&ENG,68,62,6
1996,Engineering,MATSCI&ENG,119,99,20
1996,Engineering,MATSCI&ENG,4,3,1
1997,Engineering,MATSCI&ENG,143,114,29
1998,Engineering,MATSCI&ENG,161,129,32
1999,Engineering,MATSCI&ENG,189,149,40
2000,Engineering,MATSCI&ENG,165,125,40
2001,Engineering,MATSCI&ENG,169,133,36
2002,Engineering,MATSCI&ENG,187,138,49
2002,Engineering,MATSCI&ENG,2,1,1
2003,Engineering,MATSCI&ENG,210,155,55
2003,Engineering,MATSCI&ENG,3,2,1
1992,ACES,Mechanical Agriculture,77,76,1
1980,Engineering,Mechanical Engineering,796,734,62
1980,Engineering,Mechanical Engineering,7,5,2
1980,Engineering,Mechanical Engineering,85,76,9
1980,Engineering,Mechanical Engineering,124,119,5
1981,Engineering,Mechanical Engineering,806,741,65
1981,Engineering,Mechanical Engineering,82,72,10
1981,Engineering,Mechanical Engineering,130,123,7
1982,Engineering,Mechanical Engineering,748,680,68
1982,Engineering,Mechanical Engineering,9,7,2
1982,Engineering,Mechanical Engineering,70,63,7
1982,Engineering,Mechanical Engineering,127,118,9
1983,Engineering,Mechanical Engineering,681,618,63
1983,Engineering,Mechanical Engineering,7,6,1
1983,Engineering,Mechanical Engineering,50,46,4
1983,Engineering,Mechanical Engineering,129,119,10
1984,Engineering,Mechanical Engineering,681,611,70
1984,Engineering,Mechanical Engineering,5,4,1
1984,Engineering,Mechanical Engineering,38,37,1
1984,Engineering,Mechanical Engineering,155,141,14
1985,Engineering,Mechanical Engineering,780,694,86
1985,Engineering,Mechanical Engineering,33,32,1
1985,Engineering,Mechanical Engineering,149,137,12
1986,Engineering,Mechanical Engineering,782,691,91
1986,Engineering,Mechanical Engineering,9,8,1
1986,Engineering,Mechanical Engineering,45,37,8
1986,Engineering,Mechanical Engineering,174,160,14
1987,Engineering,Mechanical Engineering,747,662,85
1987,Engineering,Mechanical Engineering,16,15,1
1987,Engineering,Mechanical Engineering,62,48,14
1987,Engineering,Mechanical Engineering,181,162,19
1988,Engineering,Mechanical Engineering,669,595,74
1988,Engineering,Mechanical Engineering,17,16,1
1988,Engineering,Mechanical Engineering,81,60,21
1988,Engineering,Mechanical Engineering,204,183,21
1989,Engineering,Mechanical Engineering,576,523,53
1989,Engineering,Mechanical Engineering,11,9,2
1989,Engineering,Mechanical Engineering,80,63,17
1989,Engineering,Mechanical Engineering,187,170,17
1990,Engineering,Mechanical Engineering,634,581,53
1990,Engineering,Mechanical Engineering,9,8,1
1990,Engineering,Mechanical Engineering,87,76,11
1990,Engineering,Mechanical Engineering,203,188,15
1991,Engineering,Mechanical Engineering,712,649,63
1991,Engineering,Mechanical Engineering,61,56,5
1991,Engineering,Mechanical Engineering,225,209,16
1992,Engineering,Mechanical Engineering,706,634,72
1992,Engineering,Mechanical Engineering,53,51,2
1992,Engineering,Mechanical Engineering,229,215,14
1993,Engineering,Mechanical Engineering,692,622,70
1993,Engineering,Mechanical Engineering,67,60,7
1993,Engineering,Mechanical Engineering,245,225,20
1994,Engineering,Mechanical Engineering,721,647,74
1994,Engineering,Mechanical Engineering,72,60,12
1994,Engineering,Mechanical Engineering,241,216,25
1995,Engineering,Mechanical Engineering,723,632,91
1995,Engineering,Mechanical Engineering,71,58,13
1995,Engineering,Mechanical Engineering,234,212,22
1996,Engineering,Mechanical Engineering,731,632,99
1996,Engineering,Mechanical Engineering,3,2,1
1996,Engineering,Mechanical Engineering,76,61,15
1996,Engineering,Mechanical Engineering,219,199,20
1997,Engineering,Mechanical Engineering,738,629,109
1997,Engineering,Mechanical Engineering,2,1,1
1997,Engineering,Mechanical Engineering,42,33,9
1997,Engineering,Mechanical Engineering,203,180,23
1998,Engineering,Mechanical Engineering,733,629,104
1998,Engineering,Mechanical Engineering,35,32,3
1998,Engineering,Mechanical Engineering,219,197,22
1999,Engineering,Mechanical Engineering,665,576,89
1999,Engineering,Mechanical Engineering,35,32,3
1999,Engineering,Mechanical Engineering,229,205,24
2000,Engineering,Mechanical Engineering,634,560,74
2000,Engineering,Mechanical Engineering,6,5,1
2000,Engineering,Mechanical Engineering,30,25,5
2000,Engineering,Mechanical Engineering,221,201,20
2001,Engineering,Mechanical Engineering,669,604,65
2001,Engineering,Mechanical Engineering,8,7,1
2001,Engineering,Mechanical Engineering,21,17,4
2001,Engineering,Mechanical Engineering,220,204,16
2002,Engineering,Mechanical Engineering,626,560,66
2002,Engineering,Mechanical Engineering,4,3,1
2002,Engineering,Mechanical Engineering,15,13,2
2002,Engineering,Mechanical Engineering,243,226,17
2003,Engineering,Mechanical Engineering,685,603,82
2003,Engineering,Mechanical Engineering,4,3,1
2003,Engineering,Mechanical Engineering,17,15,2
2003,Engineering,Mechanical Engineering,248,224,24
2018,Engineering,Mechanical Engineering,860,671,189
2018,Engineering,Mechanical Engineering,36,31,5
2018,Engineering,Mechanical Engineering,22,22,0
2018,Engineering,Mechanical Engineering,111,91,20
2018,Engineering,Mechanical Engineering,8,8,0
2018,Engineering,Mechanical Engineering,3,3,0
2018,Engineering,Mechanical Engineering,237,204,33
2018,Engineering,Mechanical Engineering,8,7,1
2017,Engineering,Mechanical Engineering,859,687,172
2017,Engineering,Mechanical Engineering,51,43,8
2017,Engineering,Mechanical Engineering,14,11,3
2017,Engineering,Mechanical Engineering,139,115,24
2017,Engineering,Mechanical Engineering,11,11,0
2017,Engineering,Mechanical Engineering,5,4,1
2017,Engineering,Mechanical Engineering,221,194,27
2017,Engineering,Mechanical Engineering,6,6,0
2016,Engineering,Mechanical Engineering,897,728,169
2016,Engineering,Mechanical Engineering,30,25,5
2016,Engineering,Mechanical Engineering,152,130,22
2016,Engineering,Mechanical Engineering,1,1,0
2016,Engineering,Mechanical Engineering,1,1,0
2016,Engineering,Mechanical Engineering,187,164,23
2016,Engineering,Mechanical Engineering,1,1,0
2015,Engineering,Mechanical Engineering,4,3,1
2015,Engineering,Mechanical Engineering,7,7,0
2015,Engineering,Mechanical Engineering,164,146,18
2015,Engineering,Mechanical Engineering,183,159,24
2015,Engineering,Mechanical Engineering,893,754,139
2014,Engineering,Mechanical Engineering,183,159,24
2014,Engineering,Mechanical Engineering,162,144,18
2014,Engineering,Mechanical Engineering,886,754,132
2013,Engineering,Mechanical Engineering,163,144,19
2013,Engineering,Mechanical Engineering,165,139,26
2013,Engineering,Mechanical Engineering,869,758,110
2012,Engineering,Mechanical Engineering,136,108,28
2012,Engineering,Mechanical Engineering,2,2,0
2012,Engineering,Mechanical Engineering,158,141,17
2012,Engineering,Mechanical Engineering,814,705,108
2011,Engineering,Mechanical Engineering,1,1,0
2011,Engineering,Mechanical Engineering,127,111,16
2011,Engineering,Mechanical Engineering,3,3,0
2011,Engineering,Mechanical Engineering,150,134,16
2011,Engineering,Mechanical Engineering,774,678,94
2010,Engineering,Mechanical Engineering,2,2,0
2010,Engineering,Mechanical Engineering,141,129,12
2010,Engineering,Mechanical Engineering,9,8,1
2010,Engineering,Mechanical Engineering,140,123,17
2010,Engineering,Mechanical Engineering,800,716,82
2009,Engineering,Mechanical Engineering,2,2,0
2009,Engineering,Mechanical Engineering,20,20,0
2009,Engineering,Mechanical Engineering,132,121,11
2009,Engineering,Mechanical Engineering,135,115,20
2009,Engineering,Mechanical Engineering,763,678,83
2008,Engineering,Mechanical Engineering,15,14,1
2008,Engineering,Mechanical Engineering,13,13,0
2008,Engineering,Mechanical Engineering,109,97,12
2008,Engineering,Mechanical Engineering,117,101,16
2008,Engineering,Mechanical Engineering,845,743,100
2007,Engineering,Mechanical Engineering,6,6,0
2007,Engineering,Mechanical Engineering,13,12,1
2007,Engineering,Mechanical Engineering,91,75,16
2007,Engineering,Mechanical Engineering,128,112,16
2007,Engineering,Mechanical Engineering,852,750,100
2006,Engineering,Mechanical Engineering,11,9,2
2006,Engineering,Mechanical Engineering,5,5,0
2006,Engineering,Mechanical Engineering,90,79,11
2006,Engineering,Mechanical Engineering,838,742,94
2006,Engineering,Mechanical Engineering,135,117,18
2005,Engineering,Mechanical Engineering,1,1,0
2005,Engineering,Mechanical Engineering,10,9,1
2005,Engineering,Mechanical Engineering,6,5,1
2005,Engineering,Mechanical Engineering,99,88,11
2005,Engineering,Mechanical Engineering,120,104,16
2005,Engineering,Mechanical Engineering,819,724,92
2004,Engineering,Mechanical Engineering,777,689,88
2004,Engineering,Mechanical Engineering,108,97,11
2004,Engineering,Mechanical Engineering,5,4,1
2004,Engineering,Mechanical Engineering,124,109,15
2018,Media,Media and Cinema Studies,85,39,46
2018,Media,Media and Cinema Studies,19,8,11
2018,Media,Media and Cinema Studies,12,3,9
2017,Media,Media and Cinema Studies,35,14,21
2017,Media,Media and Cinema Studies,35,17,18
2017,Media,Media and Cinema Studies,28,8,20
2016,Media,Media and Cinema Studies,27,10,17
2016,Media,Media and Cinema Studies,35,19,16
2016,Media,Media and Cinema Studies,35,9,26
2015,Media,Media and Cinema Studies,36,18,18
2015,Media,Media and Cinema Studies,16,5,11
2015,Media,Media and Cinema Studies,35,11,24
2014,Media,Media and Cinema Studies,17,5,12
2014,Media,Media and Cinema Studies,40,23,17
2014,Media,Media and Cinema Studies,41,16,25
2013,Media,Media and Cinema Studies,11,5,6
2013,Media,Media and Cinema Studies,43,17,25
2013,Media,Media and Cinema Studies,38,20,18
2012,Media,Media and Cinema Studies,9,5,4
2012,Media,Media and Cinema Studies,49,18,30
2012,Media,Media and Cinema Studies,56,34,22
2011,Media,Media and Cinema Studies,36,22,14
2011,Media,Media and Cinema Studies,36,21,15
2011,Media,Media and Cinema Studies,46,16,30
2010,Media,Media and Cinema Studies,16,15,1
2010,Media,Media and Cinema Studies,24,14,10
2010,Media,Media and Cinema Studies,22,4,18
2009,Media,Media and Cinema Studies,1,1,0
2013,Media,Media Studies,1,1,0
2012,Media,Media Studies,2,0,2
2011,Media,Media Studies,12,2,10
2010,Media,Media Studies,59,17,42
2009,Media,Media Studies,110,31,79
2008,Media,Media Studies,102,31,71
2007,Media,Media Studies,95,31,64
2006,Media,Media Studies,128,44,84
2005,Media,Media Studies,122,34,88
2004,Media,Media Studies,101,26,75
1985,Media,Media Studies,8,2,6
1986,Media,Media Studies,22,3,19
1987,Media,Media Studies,27,7,20
1988,Media,Media Studies,29,13,16
1989,Media,Media Studies,29,13,16
1990,Media,Media Studies,34,13,21
1991,Media,Media Studies,37,19,18
1992,Media,Media Studies,30,11,19
1993,Media,Media Studies,35,14,21
1994,Media,Media Studies,34,14,20
1995,Media,Media Studies,29,11,18
1996,Media,Media Studies,26,14,12
1997,Media,Media Studies,32,16,16
1998,Media,Media Studies,51,23,28
1999,Media,Media Studies,52,22,30
2000,Media,Media Studies,45,20,25
2001,Media,Media Studies,51,24,27
2002,Media,Media Studies,79,30,49
2003,Media,Media Studies,94,30,64
2018,Medicine,Medicine - Carle Illinois COM,32,15,15
1980,Engineering,METAL ENGR,99,79,20
1980,Engineering,METAL ENGR,10,9,1
1980,Engineering,METAL ENGR,81,71,10
1981,Engineering,METAL ENGR,93,76,17
1981,Engineering,METAL ENGR,13,10,3
1981,Engineering,METAL ENGR,90,76,14
1982,Engineering,METAL ENGR,72,56,16
1982,Engineering,METAL ENGR,12,9,3
1982,Engineering,METAL ENGR,91,77,14
1983,Engineering,METAL ENGR,77,62,15
1983,Engineering,METAL ENGR,4,2,2
1983,Engineering,METAL ENGR,104,89,15
1984,Engineering,METAL ENGR,54,43,11
1984,Engineering,METAL ENGR,4,2,2
1984,Engineering,METAL ENGR,107,91,16
1985,Engineering,METAL ENGR,59,47,12
1985,Engineering,METAL ENGR,5,3,2
1985,Engineering,METAL ENGR,104,91,13
1986,Engineering,METAL ENGR,64,52,12
1986,Engineering,METAL ENGR,8,5,3
1986,Engineering,METAL ENGR,112,97,15
1987,Engineering,METAL ENGR,55,45,10
1987,Engineering,METAL ENGR,9,6,3
1987,Engineering,METAL ENGR,110,96,14
1988,Engineering,METAL ENGR,45,39,6
1988,Engineering,METAL ENGR,9,6,3
1988,Engineering,METAL ENGR,111,93,18
1989,Engineering,METAL ENGR,54,45,9
1989,Engineering,METAL ENGR,7,6,1
1989,Engineering,METAL ENGR,106,90,16
1990,Engineering,METAL ENGR,56,50,6
1990,Engineering,METAL ENGR,5,3,2
1990,Engineering,METAL ENGR,102,86,16
1991,Engineering,METAL ENGR,53,45,8
1991,Engineering,METAL ENGR,2,1,1
1991,Engineering,METAL ENGR,114,98,16
1992,Engineering,METAL ENGR,51,45,6
1992,Engineering,METAL ENGR,3,2,1
1992,Engineering,METAL ENGR,114,96,18
1993,Engineering,METAL ENGR,52,43,9
1993,Engineering,METAL ENGR,108,86,22
1994,Engineering,METAL ENGR,57,50,7
1994,Engineering,METAL ENGR,17,14,3
1995,Engineering,METAL ENGR,43,38,5
1995,Engineering,METAL ENGR,8,6,2
1996,Engineering,METAL ENGR,29,27,2
1996,Engineering,METAL ENGR,5,3,2
1997,Engineering,METAL ENGR,3,2,1
1998,Engineering,METAL ENGR,3,2,1
2018,LAS,Microbiology,49,20,29
2017,LAS,Microbiology,53,20,33
2016,LAS,Microbiology,55,22,33
2015,LAS,Microbiology,1,1,0
2015,LAS,Microbiology,54,21,33
2014,LAS,Microbiology,1,1,0
2014,LAS,Microbiology,53,20,33
2013,LAS,Microbiology,52,24,28
2012,LAS,Microbiology,1,1,0
2012,LAS,Microbiology,58,24,34
2011,LAS,Microbiology,60,21,39
2010,LAS,Microbiology,67,24,43
2009,LAS,Microbiology,2,0,2
2009,LAS,Microbiology,2,2,0
2009,LAS,Microbiology,64,26,38
2008,LAS,Microbiology,3,1,2
2008,LAS,Microbiology,69,31,38
2007,LAS,Microbiology,2,1,1
2007,LAS,Microbiology,69,31,38
2006,LAS,Microbiology,2,0,2
2006,LAS,Microbiology,1,0,1
2006,LAS,Microbiology,72,32,40
2005,LAS,Microbiology,3,0,3
2005,LAS,Microbiology,1,1,0
2005,LAS,Microbiology,82,36,46
2004,LAS,Microbiology,10,5,5
2004,LAS,Microbiology,2,1,1
2004,LAS,Microbiology,65,25,40
1980,LAS,Microbiology,59,34,25
1981,LAS,Microbiology,61,33,28
1982,LAS,Microbiology,73,40,33
1983,LAS,Microbiology,67,37,30
1984,LAS,Microbiology,65,42,23
1985,LAS,Microbiology,59,36,23
1986,LAS,Microbiology,60,38,22
1987,LAS,Microbiology,63,37,26
1988,LAS,Microbiology,62,39,23
1989,LAS,Microbiology,63,35,28
1990,LAS,Microbiology,69,39,30
1991,LAS,Microbiology,69,43,26
1992,LAS,Microbiology,60,39,21
1993,LAS,Microbiology,72,44,28
1994,LAS,Microbiology,73,47,26
1995,LAS,Microbiology,79,51,28
1996,LAS,Microbiology,61,36,25
1997,LAS,Microbiology,65,37,28
1998,LAS,Microbiology,56,32,24
1999,LAS,Microbiology,54,24,30
2000,LAS,Microbiology,52,26,26
2001,LAS,Microbiology,49,23,26
2002,LAS,Microbiology,52,25,27
2003,LAS,Microbiology,60,23,37
2018,Education,Middle Grades Education,26,6,20
2018,Education,Middle Grades Education,13,3,10
2018,Education,Middle Grades Education,35,10,25
2018,Education,Middle Grades Education,4,0,4
2018,Education,Middle Grades Education,4,1,3
2017,Education,Middle Grades Education,16,2,14
2017,Education,Middle Grades Education,7,2,5
2017,Education,Middle Grades Education,41,9,32
2017,Education,Middle Grades Education,4,0,4
2017,Education,Middle Grades Education,8,4,4
2016,Education,Middle Grades Education,5,1,4
2016,Education,Middle Grades Education,27,7,20
2016,Education,Middle Grades Education,2,0,2
2016,Education,Middle Grades Education,3,0,3
1980,ACES,MKT TEXT&A,103,2,101
1981,ACES,MKT TEXT&A,98,2,96
1982,ACES,MKT TEXT&A,125,1,124
1983,ACES,MKT TEXT&A,141,4,137
1984,ACES,MKT TEXT&A,165,5,160
1985,ACES,MKT TEXT&A,192,5,187
1986,ACES,MKT TEXT&A,160,3,157
1987,ACES,MKT TEXT&A,127,4,123
1988,ACES,MKT TEXT&A,117,2,115
1989,ACES,MKT TEXT&A,117,5,112
1990,ACES,MKT TEXT&A,114,8,106
1991,ACES,MKT TEXT&A,101,2,99
1992,ACES,MKT TEXT&A,102,8,94
1993,ACES,MKT TEXT&A,103,2,101
1994,ACES,MKT TEXT&A,77,4,73
1995,ACES,MKT TEXT&A,72,4,68
1996,ACES,MKT TEXT&A,78,6,72
2018,LAS,Molecular & Integrative Physi,23,8,15
2017,LAS,Molecular & Integrative Physi,20,5,15
2016,LAS,Molecular & Integrative Physi,22,10,12
2015,LAS,Molecular & Integrative Physi,25,12,13
2014,LAS,Molecular & Integrative Physi,22,10,12
2013,LAS,Molecular & Integrative Physi,19,9,10
2012,LAS,Molecular & Integrative Physi,16,8,8
2011,LAS,Molecular & Integrative Physi,31,15,16
2010,LAS,Molecular & Integrative Physi,36,15,21
2009,LAS,Molecular & Integrative Physi,31,13,18
2008,LAS,Molecular & Integrative Physi,31,13,18
2007,LAS,Molecular & Integrative Physi,37,17,20
2006,LAS,Molecular & Integrative Physi,35,19,16
2005,LAS,Molecular & Integrative Physi,2,1,1
2005,LAS,Molecular & Integrative Physi,35,20,15
2004,LAS,Molecular & Integrative Physi,10,4,6
2004,LAS,Molecular & Integrative Physi,1,0,1
2004,LAS,Molecular & Integrative Physi,32,23,9
1980,LAS,Molecular & Integrative Physi,57,43,14
1981,LAS,Molecular & Integrative Physi,60,41,19
1982,LAS,Molecular & Integrative Physi,56,40,16
1983,LAS,Molecular & Integrative Physi,56,38,18
1984,LAS,Molecular & Integrative Physi,54,35,19
1985,LAS,Molecular & Integrative Physi,59,41,18
1986,LAS,Molecular & Integrative Physi,49,36,13
1987,LAS,Molecular & Integrative Physi,58,38,20
1988,LAS,Molecular & Integrative Physi,60,39,21
1989,LAS,Molecular & Integrative Physi,58,35,23
1990,LAS,Molecular & Integrative Physi,60,34,26
1991,LAS,Molecular & Integrative Physi,61,36,25
1992,LAS,Molecular & Integrative Physi,51,31,20
1993,LAS,Molecular & Integrative Physi,53,33,20
1994,LAS,Molecular & Integrative Physi,46,28,18
1995,LAS,Molecular & Integrative Physi,51,32,19
1996,LAS,Molecular & Integrative Physi,54,36,18
1997,LAS,Molecular & Integrative Physi,50,31,19
1998,LAS,Molecular & Integrative Physi,46,30,16
1999,LAS,Molecular & Integrative Physi,42,25,17
2000,LAS,Molecular & Integrative Physi,40,25,15
2001,LAS,Molecular & Integrative Physi,40,25,15
2002,LAS,Molecular & Integrative Physi,35,23,12
2003,LAS,Molecular & Integrative Physi,40,26,14
2018,LAS,Molecular and Cellular Biology,813,373,440
2018,LAS,Molecular and Cellular Biology,61,20,41
2018,LAS,Molecular and Cellular Biology,73,22,51
2018,LAS,Molecular and Cellular Biology,6,3,3
2017,LAS,Molecular and Cellular Biology,870,415,455
2017,LAS,Molecular and Cellular Biology,59,20,39
2017,LAS,Molecular and Cellular Biology,65,25,40
2017,LAS,Molecular and Cellular Biology,8,2,6
2016,LAS,Molecular and Cellular Biology,858,401,457
2016,LAS,Molecular and Cellular Biology,85,29,56
2016,LAS,Molecular and Cellular Biology,45,19,26
2016,LAS,Molecular and Cellular Biology,9,4,5
2015,LAS,Molecular and Cellular Biology,5,3,2
2015,LAS,Molecular and Cellular Biology,39,18,21
2015,LAS,Molecular and Cellular Biology,110,55,55
2015,LAS,Molecular and Cellular Biology,887,441,446
2014,LAS,Molecular and Cellular Biology,5,3,2
2014,LAS,Molecular and Cellular Biology,43,17,26
2014,LAS,Molecular and Cellular Biology,96,40,56
2014,LAS,Molecular and Cellular Biology,951,492,459
2013,LAS,Molecular and Cellular Biology,8,5,3
2013,LAS,Molecular and Cellular Biology,76,34,42
2013,LAS,Molecular and Cellular Biology,49,20,29
2013,LAS,Molecular and Cellular Biology,1042,543,499
2012,LAS,Molecular and Cellular Biology,1,0,1
2012,LAS,Molecular and Cellular Biology,49,28,21
2012,LAS,Molecular and Cellular Biology,7,3,4
2012,LAS,Molecular and Cellular Biology,46,18,28
2012,LAS,Molecular and Cellular Biology,1010,520,490
2011,LAS,Molecular and Cellular Biology,8,3,5
2011,LAS,Molecular and Cellular Biology,53,26,27
2011,LAS,Molecular and Cellular Biology,62,35,27
2011,LAS,Molecular and Cellular Biology,928,491,437
2010,LAS,Molecular and Cellular Biology,41,18,23
2010,LAS,Molecular and Cellular Biology,10,6,4
2010,LAS,Molecular and Cellular Biology,73,37,36
2010,LAS,Molecular and Cellular Biology,906,467,439
2009,LAS,Molecular and Cellular Biology,1,1,0
2009,LAS,Molecular and Cellular Biology,3,2,1
2009,LAS,Molecular and Cellular Biology,53,35,18
2009,LAS,Molecular and Cellular Biology,81,35,46
2009,LAS,Molecular and Cellular Biology,903,451,449
2008,LAS,Molecular and Cellular Biology,3,2,1
2008,LAS,Molecular and Cellular Biology,51,20,31
2008,LAS,Molecular and Cellular Biology,955,477,476
2007,LAS,Molecular and Cellular Biology,5,2,3
2007,LAS,Molecular and Cellular Biology,911,452,458
2006,LAS,Molecular and Cellular Biology,5,1,4
2006,LAS,Molecular and Cellular Biology,938,434,502
2005,LAS,Molecular and Cellular Biology,1,0,1
2005,LAS,Molecular and Cellular Biology,12,5,7
2005,LAS,Molecular and Cellular Biology,781,319,461
2004,LAS,Molecular and Cellular Biology,690,293,397
2002,LAS,Molecular and Cellular Biology,5,4,1
2003,LAS,Molecular and Cellular Biology,22,13,9
2018,LAS,Molecular&Cell Bio-undeclared,27,12,15
2017,LAS,Molecular&Cell Bio-undeclared,38,16,22
2016,LAS,Molecular&Cell Bio-undeclared,34,12,22
2015,LAS,Molecular&Cell Bio-undeclared,34,16,18
2014,LAS,Molecular&Cell Bio-undeclared,22,13,9
2013,LAS,Molecular&Cell Bio-undeclared,57,22,35
2012,LAS,Molecular&Cell Bio-undeclared,33,13,20
2011,LAS,Molecular&Cell Bio-undeclared,38,23,15
2010,LAS,Molecular&Cell Bio-undeclared,36,16,20
2009,LAS,Molecular&Cell Bio-undeclared,61,30,31
2008,LAS,Molecular&Cell Bio-undeclared,31,16,15
2007,LAS,Molecular&Cell Bio-undeclared,24,11,13
2006,LAS,Molecular&Cell Bio-undeclared,45,15,30
2005,LAS,Molecular&Cell Bio-undeclared,18,10,8
2004,LAS,Molecular&Cell Bio-undeclared,12,7,5
1980,Applied Health Sciences,MOTOR DEV,33,3,30
1981,Applied Health Sciences,MOTOR DEV,33,7,26
1982,Applied Health Sciences,MOTOR DEV,23,2,21
1980,Applied Health Sciences,MOTOR P&SP,28,14,14
1981,Applied Health Sciences,MOTOR P&SP,25,8,17
1982,Applied Health Sciences,MOTOR P&SP,18,9,9
1983,Applied Health Sciences,MOTOR P&SP,11,6,5
1984,Applied Health Sciences,MOTOR P&SP,3,1,2
1991,Applied Health Sciences,MSPH IN C HLTH,5,2,3
1993,Applied Health Sciences,MSPH IN C HLTH,12,1,11
1994,Applied Health Sciences,MSPH IN C HLTH,10,1,9
1997,Applied Health Sciences,MSPH IN C HLTH,6,2,4
1998,Applied Health Sciences,MSPH IN C HLTH,7,2,5
2000,Applied Health Sciences,MSPH IN C HLTH,8,1,7
1980,Fine and Applied Arts,MUS-VOICE,44,15,29
1981,Fine and Applied Arts,MUS-VOICE,40,11,29
1982,Fine and Applied Arts,MUS-VOICE,48,15,33
1983,Fine and Applied Arts,MUS-VOICE,48,14,34
1984,Fine and Applied Arts,MUS-VOICE,47,14,33
1985,Fine and Applied Arts,MUS-VOICE,55,18,37
1986,Fine and Applied Arts,MUS-VOICE,52,14,38
1987,Fine and Applied Arts,MUS-VOICE,44,12,32
1988,Fine and Applied Arts,MUS-VOICE,37,8,29
1989,Fine and Applied Arts,MUS-VOICE,32,7,25
1990,Fine and Applied Arts,MUS-VOICE,42,9,33
1991,Fine and Applied Arts,MUS-VOICE,41,9,32
1992,Fine and Applied Arts,MUS-VOICE,51,10,41
1993,Fine and Applied Arts,MUS-VOICE,48,16,32
1994,Fine and Applied Arts,MUS-VOICE,48,15,33
1995,Fine and Applied Arts,MUS-VOICE,57,19,38
1996,Fine and Applied Arts,MUS-VOICE,45,13,32
1997,Fine and Applied Arts,MUS-VOICE,45,10,35
1998,Fine and Applied Arts,MUS-VOICE,53,14,39
1999,Fine and Applied Arts,MUS-VOICE,49,12,37
2000,Fine and Applied Arts,MUS-VOICE,43,9,34
2001,Fine and Applied Arts,MUS-VOICE,43,9,34
2002,Fine and Applied Arts,MUS-VOICE,25,3,22
2003,Fine and Applied Arts,MUS-VOICE,29,5,24
1980,Fine and Applied Arts,Music,251,144,107
1981,Fine and Applied Arts,Music,241,142,99
1982,Fine and Applied Arts,Music,218,110,108
1983,Fine and Applied Arts,Music,210,110,100
1984,Fine and Applied Arts,Music,201,95,106
1985,Fine and Applied Arts,Music,159,65,94
1986,Fine and Applied Arts,Music,151,69,82
1987,Fine and Applied Arts,Music,158,69,89
1988,Fine and Applied Arts,Music,129,53,76
1989,Fine and Applied Arts,Music,136,66,70
1990,Fine and Applied Arts,Music,144,72,72
1991,Fine and Applied Arts,Music,144,68,76
1992,Fine and Applied Arts,Music,142,62,80
1993,Fine and Applied Arts,Music,137,59,78
1994,Fine and Applied Arts,Music,147,67,80
1995,Fine and Applied Arts,Music,148,59,89
1996,Fine and Applied Arts,Music,144,60,84
1997,Fine and Applied Arts,Music,139,56,83
1998,Fine and Applied Arts,Music,142,66,76
1999,Fine and Applied Arts,Music,146,60,86
2000,Fine and Applied Arts,Music,159,76,83
2001,Fine and Applied Arts,Music,137,64,73
2002,Fine and Applied Arts,Music,141,60,81
2003,Fine and Applied Arts,Music,148,60,88
2018,Fine and Applied Arts,Music,7,1,6
2018,Fine and Applied Arts,Music,9,7,2
2018,Fine and Applied Arts,Music,115,43,72
2018,Fine and Applied Arts,Music,14,13,1
2018,Fine and Applied Arts,Music,3,1,2
2018,Fine and Applied Arts,Music,33,27,6
2018,Fine and Applied Arts,Music,3,2,1
2018,Fine and Applied Arts,Music,1,1,0
2018,Fine and Applied Arts,Music,54,32,22
2018,Fine and Applied Arts,Music,62,29,33
2018,Fine and Applied Arts,Music,4,3,1
2018,Fine and Applied Arts,Music,9,1,8
2018,Fine and Applied Arts,Music,3,1,2
2018,Fine and Applied Arts,Music,1,1,0
2018,Fine and Applied Arts,Music,3,2,1
2018,Fine and Applied Arts,Music,1,0,1
2018,Fine and Applied Arts,Music,16,14,2
2017,Fine and Applied Arts,Music,9,1,8
2017,Fine and Applied Arts,Music,3,1,2
2017,Fine and Applied Arts,Music,9,7,2
2017,Fine and Applied Arts,Music,122,46,76
2017,Fine and Applied Arts,Music,16,15,1
2017,Fine and Applied Arts,Music,6,3,3
2017,Fine and Applied Arts,Music,38,31,7
2017,Fine and Applied Arts,Music,4,3,1
2017,Fine and Applied Arts,Music,2,2,0
2017,Fine and Applied Arts,Music,44,35,9
2017,Fine and Applied Arts,Music,1,0,1
2017,Fine and Applied Arts,Music,62,32,30
2017,Fine and Applied Arts,Music,4,3,1
2017,Fine and Applied Arts,Music,9,1,8
2017,Fine and Applied Arts,Music,2,0,2
2017,Fine and Applied Arts,Music,1,1,0
2017,Fine and Applied Arts,Music,3,3,0
2017,Fine and Applied Arts,Music,3,1,2
2017,Fine and Applied Arts,Music,12,12,0
2016,Fine and Applied Arts,Music,7,1,6
2016,Fine and Applied Arts,Music,6,3,3
2016,Fine and Applied Arts,Music,13,9,4
2016,Fine and Applied Arts,Music,129,45,84
2016,Fine and Applied Arts,Music,16,14,2
2016,Fine and Applied Arts,Music,4,2,2
2016,Fine and Applied Arts,Music,38,32,6
2016,Fine and Applied Arts,Music,2,2,0
2016,Fine and Applied Arts,Music,2,2,0
2016,Fine and Applied Arts,Music,36,29,7
2016,Fine and Applied Arts,Music,1,1,0
2016,Fine and Applied Arts,Music,1,1,0
2016,Fine and Applied Arts,Music,60,32,28
2016,Fine and Applied Arts,Music,7,6,1
2016,Fine and Applied Arts,Music,8,2,6
2016,Fine and Applied Arts,Music,2,0,2
2016,Fine and Applied Arts,Music,2,2,0
2016,Fine and Applied Arts,Music,2,2,0
2016,Fine and Applied Arts,Music,3,1,2
2016,Fine and Applied Arts,Music,9,7,2
2015,Fine and Applied Arts,Music,1,1,0
2015,Fine and Applied Arts,Music,1,1,0
2015,Fine and Applied Arts,Music,1,0,1
2015,Fine and Applied Arts,Music,2,2,0
2015,Fine and Applied Arts,Music,3,3,0
2015,Fine and Applied Arts,Music,3,2,1
2015,Fine and Applied Arts,Music,2,2,0
2015,Fine and Applied Arts,Music,2,0,2
2015,Fine and Applied Arts,Music,4,4,0
2015,Fine and Applied Arts,Music,5,3,2
2015,Fine and Applied Arts,Music,7,3,4
2015,Fine and Applied Arts,Music,26,21,5
2015,Fine and Applied Arts,Music,8,4,4
2015,Fine and Applied Arts,Music,7,2,5
2015,Fine and Applied Arts,Music,13,10,3
2015,Fine and Applied Arts,Music,15,7,8
2015,Fine and Applied Arts,Music,20,17,3
2015,Fine and Applied Arts,Music,33,28,5
2015,Fine and Applied Arts,Music,53,25,28
2015,Fine and Applied Arts,Music,135,42,93
2014,Fine and Applied Arts,Music,1,1,0
2014,Fine and Applied Arts,Music,2,2,0
2014,Fine and Applied Arts,Music,2,2,0
2014,Fine and Applied Arts,Music,3,3,0
2014,Fine and Applied Arts,Music,2,2,0
2014,Fine and Applied Arts,Music,2,1,1
2014,Fine and Applied Arts,Music,3,1,2
2014,Fine and Applied Arts,Music,4,2,2
2014,Fine and Applied Arts,Music,24,15,9
2014,Fine and Applied Arts,Music,8,7,1
2014,Fine and Applied Arts,Music,7,1,6
2014,Fine and Applied Arts,Music,12,9,3
2014,Fine and Applied Arts,Music,10,5,5
2014,Fine and Applied Arts,Music,9,7,2
2014,Fine and Applied Arts,Music,11,6,5
2014,Fine and Applied Arts,Music,15,12,3
2014,Fine and Applied Arts,Music,26,24,2
2014,Fine and Applied Arts,Music,54,23,31
2014,Fine and Applied Arts,Music,147,44,103
2013,Fine and Applied Arts,Music,5,3,2
2013,Fine and Applied Arts,Music,11,4,7
2013,Fine and Applied Arts,Music,7,4,3
2013,Fine and Applied Arts,Music,16,12,4
2013,Fine and Applied Arts,Music,2,1,1
2013,Fine and Applied Arts,Music,3,3,0
2013,Fine and Applied Arts,Music,4,4,0
2013,Fine and Applied Arts,Music,10,8,2
2013,Fine and Applied Arts,Music,6,5,1
2013,Fine and Applied Arts,Music,3,3,0
2013,Fine and Applied Arts,Music,2,2,0
2013,Fine and Applied Arts,Music,1,1,0
2013,Fine and Applied Arts,Music,23,22,1
2013,Fine and Applied Arts,Music,7,0,7
2013,Fine and Applied Arts,Music,146,46,100
2013,Fine and Applied Arts,Music,53,20,33
2013,Fine and Applied Arts,Music,29,18,11
2013,Fine and Applied Arts,Music,18,13,5
2012,Fine and Applied Arts,Music,7,2,5
2012,Fine and Applied Arts,Music,16,7,9
2012,Fine and Applied Arts,Music,8,5,3
2012,Fine and Applied Arts,Music,15,10,5
2012,Fine and Applied Arts,Music,7,3,4
2012,Fine and Applied Arts,Music,1,1,0
2012,Fine and Applied Arts,Music,3,2,1
2012,Fine and Applied Arts,Music,6,4,2
2012,Fine and Applied Arts,Music,6,4,2
2012,Fine and Applied Arts,Music,7,1,6
2012,Fine and Applied Arts,Music,3,3,0
2012,Fine and Applied Arts,Music,2,2,0
2012,Fine and Applied Arts,Music,2,1,1
2012,Fine and Applied Arts,Music,139,50,88
2012,Fine and Applied Arts,Music,27,13,14
2012,Fine and Applied Arts,Music,42,17,25
2012,Fine and Applied Arts,Music,16,12,4
2012,Fine and Applied Arts,Music,22,21,1
2011,Fine and Applied Arts,Music,5,1,4
2011,Fine and Applied Arts,Music,23,11,12
2011,Fine and Applied Arts,Music,10,4,6
2011,Fine and Applied Arts,Music,20,15,5
2011,Fine and Applied Arts,Music,6,2,4
2011,Fine and Applied Arts,Music,6,2,4
2011,Fine and Applied Arts,Music,4,1,3
2011,Fine and Applied Arts,Music,6,5,1
2011,Fine and Applied Arts,Music,8,2,6
2011,Fine and Applied Arts,Music,2,2,0
2011,Fine and Applied Arts,Music,5,4,1
2011,Fine and Applied Arts,Music,2,0,2
2011,Fine and Applied Arts,Music,22,22,0
2011,Fine and Applied Arts,Music,30,15,14
2011,Fine and Applied Arts,Music,127,46,80
2011,Fine and Applied Arts,Music,54,21,33
2011,Fine and Applied Arts,Music,16,14,2
2010,Fine and Applied Arts,Music,4,1,3
2010,Fine and Applied Arts,Music,36,17,19
2010,Fine and Applied Arts,Music,11,4,7
2010,Fine and Applied Arts,Music,19,15,4
2010,Fine and Applied Arts,Music,7,2,5
2010,Fine and Applied Arts,Music,9,4,5
2010,Fine and Applied Arts,Music,1,0,1
2010,Fine and Applied Arts,Music,10,7,3
2010,Fine and Applied Arts,Music,8,2,6
2010,Fine and Applied Arts,Music,2,1,1
2010,Fine and Applied Arts,Music,2,2,0
2010,Fine and Applied Arts,Music,3,1,2
2010,Fine and Applied Arts,Music,1,0,1
2010,Fine and Applied Arts,Music,128,47,81
2010,Fine and Applied Arts,Music,14,13,1
2010,Fine and Applied Arts,Music,21,19,2
2010,Fine and Applied Arts,Music,27,16,11
2010,Fine and Applied Arts,Music,54,22,32
2009,Fine and Applied Arts,Music,2,1,1
2009,Fine and Applied Arts,Music,14,9,5
2009,Fine and Applied Arts,Music,1,1,0
2009,Fine and Applied Arts,Music,2,2,0
2009,Fine and Applied Arts,Music,2,1,1
2009,Fine and Applied Arts,Music,3,1,2
2009,Fine and Applied Arts,Music,7,7,0
2009,Fine and Applied Arts,Music,5,1,4
2009,Fine and Applied Arts,Music,7,3,4
2009,Fine and Applied Arts,Music,12,5,7
2009,Fine and Applied Arts,Music,23,21,2
2009,Fine and Applied Arts,Music,14,8,6
2009,Fine and Applied Arts,Music,18,12,6
2009,Fine and Applied Arts,Music,37,18,19
2009,Fine and Applied Arts,Music,35,15,20
2009,Fine and Applied Arts,Music,41,20,21
2009,Fine and Applied Arts,Music,122,43,79
2008,Fine and Applied Arts,Music,1,0,1
2008,Fine and Applied Arts,Music,1,1,0
2008,Fine and Applied Arts,Music,1,1,0
2008,Fine and Applied Arts,Music,1,1,0
2008,Fine and Applied Arts,Music,2,0,2
2008,Fine and Applied Arts,Music,2,1,1
2008,Fine and Applied Arts,Music,3,0,3
2008,Fine and Applied Arts,Music,19,10,9
2008,Fine and Applied Arts,Music,6,5,1
2008,Fine and Applied Arts,Music,7,3,4
2008,Fine and Applied Arts,Music,4,4,0
2008,Fine and Applied Arts,Music,6,2,4
2008,Fine and Applied Arts,Music,17,17,0
2008,Fine and Applied Arts,Music,11,6,5
2008,Fine and Applied Arts,Music,16,9,7
2008,Fine and Applied Arts,Music,40,19,21
2008,Fine and Applied Arts,Music,41,21,20
2008,Fine and Applied Arts,Music,45,19,26
2008,Fine and Applied Arts,Music,125,43,82
2007,Fine and Applied Arts,Music,1,1,0
2007,Fine and Applied Arts,Music,17,12,5
2007,Fine and Applied Arts,Music,112,59,53
2007,Fine and Applied Arts,Music,206,92,114
2006,Fine and Applied Arts,Music,1,0,1
2006,Fine and Applied Arts,Music,18,11,7
2006,Fine and Applied Arts,Music,9,5,4
2006,Fine and Applied Arts,Music,105,53,51
2006,Fine and Applied Arts,Music,184,77,107
2005,Fine and Applied Arts,Music,3,2,1
2005,Fine and Applied Arts,Music,3,0,3
2005,Fine and Applied Arts,Music,7,3,4
2005,Fine and Applied Arts,Music,108,53,55
2005,Fine and Applied Arts,Music,156,65,91
2004,Fine and Applied Arts,Music,121,49,72
2004,Fine and Applied Arts,Music,124,52,72
2004,Fine and Applied Arts,Music,1,0,1
2004,Fine and Applied Arts,Music,3,1,2
2007,LAS,Music,1,1,0
2006,LAS,Music,7,3,4
2006,LAS,Music,1,0,1
2005,LAS,Music,17,10,7
2004,LAS,Music,19,13,6
2004,LAS,Music,1,1,0
2018,Fine and Applied Arts,Music Composition,10,10,0
2017,Fine and Applied Arts,Music Composition,9,9,0
2016,Fine and Applied Arts,Music Composition,8,8,0
2015,Fine and Applied Arts,Music Composition,8,7,1
2014,Fine and Applied Arts,Music Composition,8,7,1
2013,Fine and Applied Arts,Music Composition,9,8,1
2012,Fine and Applied Arts,Music Composition,5,5,0
2011,Fine and Applied Arts,Music Composition,9,6,3
2010,Fine and Applied Arts,Music Composition,12,9,3
2009,Fine and Applied Arts,Music Composition,11,9,2
2008,Fine and Applied Arts,Music Composition,9,6,3
2007,Fine and Applied Arts,Music Composition,8,7,1
2006,Fine and Applied Arts,Music Composition,12,10,2
2005,Fine and Applied Arts,Music Composition,9,8,1
2004,Fine and Applied Arts,Music Composition,12,11,1
1980,Fine and Applied Arts,Music Education,63,39,24
1981,Fine and Applied Arts,Music Education,70,44,26
1982,Fine and Applied Arts,Music Education,57,38,19
1983,Fine and Applied Arts,Music Education,56,36,20
1984,Fine and Applied Arts,Music Education,62,31,31
1985,Fine and Applied Arts,Music Education,75,47,28
1986,Fine and Applied Arts,Music Education,53,30,23
1987,Fine and Applied Arts,Music Education,55,31,24
1988,Fine and Applied Arts,Music Education,47,24,23
1989,Fine and Applied Arts,Music Education,33,12,21
1990,Fine and Applied Arts,Music Education,29,14,15
1991,Fine and Applied Arts,Music Education,37,19,18
1992,Fine and Applied Arts,Music Education,43,19,24
1993,Fine and Applied Arts,Music Education,49,22,27
1994,Fine and Applied Arts,Music Education,44,19,25
1995,Fine and Applied Arts,Music Education,43,20,23
1996,Fine and Applied Arts,Music Education,42,24,18
1997,Fine and Applied Arts,Music Education,54,28,26
1998,Fine and Applied Arts,Music Education,33,18,15
1999,Fine and Applied Arts,Music Education,33,13,20
2000,Fine and Applied Arts,Music Education,35,17,18
2001,Fine and Applied Arts,Music Education,29,13,16
2002,Fine and Applied Arts,Music Education,25,9,16
2003,Fine and Applied Arts,Music Education,20,8,12
1980,Fine and Applied Arts,Music Education,246,91,155
1981,Fine and Applied Arts,Music Education,235,90,145
1982,Fine and Applied Arts,Music Education,237,92,145
1983,Fine and Applied Arts,Music Education,195,76,119
1984,Fine and Applied Arts,Music Education,176,72,104
1985,Fine and Applied Arts,Music Education,194,72,122
1986,Fine and Applied Arts,Music Education,224,87,137
1987,Fine and Applied Arts,Music Education,235,92,143
1988,Fine and Applied Arts,Music Education,226,87,139
1989,Fine and Applied Arts,Music Education,219,92,127
1990,Fine and Applied Arts,Music Education,202,78,124
1991,Fine and Applied Arts,Music Education,197,80,117
1992,Fine and Applied Arts,Music Education,190,88,102
1993,Fine and Applied Arts,Music Education,217,98,119
1994,Fine and Applied Arts,Music Education,219,90,129
1995,Fine and Applied Arts,Music Education,247,103,144
1996,Fine and Applied Arts,Music Education,282,112,170
1997,Fine and Applied Arts,Music Education,286,113,173
1998,Fine and Applied Arts,Music Education,261,101,160
1999,Fine and Applied Arts,Music Education,260,98,162
2000,Fine and Applied Arts,Music Education,237,93,144
2001,Fine and Applied Arts,Music Education,206,80,126
2002,Fine and Applied Arts,Music Education,223,86,137
2003,Fine and Applied Arts,Music Education,200,76,124
2018,Fine and Applied Arts,Music Education,36,16,20
2018,Fine and Applied Arts,Music Education,20,4,16
2018,Fine and Applied Arts,Music Education,69,37,32
2018,Fine and Applied Arts,Music Education,7,2,5
2018,Fine and Applied Arts,Music Education,4,2,2
2018,Fine and Applied Arts,Music Education,1,1,0
2018,Fine and Applied Arts,Music Education,10,6,4
2018,Fine and Applied Arts,Music Education,5,4,1
2017,Fine and Applied Arts,Music Education,31,3,28
2017,Fine and Applied Arts,Music Education,104,54,50
2017,Fine and Applied Arts,Music Education,15,2,13
2017,Fine and Applied Arts,Music Education,10,7,3
2017,Fine and Applied Arts,Music Education,6,5,1
2016,Fine and Applied Arts,Music Education,1,0,1
2016,Fine and Applied Arts,Music Education,36,7,29
2016,Fine and Applied Arts,Music Education,113,51,62
2016,Fine and Applied Arts,Music Education,16,5,11
2016,Fine and Applied Arts,Music Education,8,6,2
2016,Fine and Applied Arts,Music Education,7,6,1
2015,Fine and Applied Arts,Music Education,13,1,12
2015,Fine and Applied Arts,Music Education,1,0,1
2015,Fine and Applied Arts,Music Education,41,13,28
2015,Fine and Applied Arts,Music Education,6,5,1
2015,Fine and Applied Arts,Music Education,5,2,3
2015,Fine and Applied Arts,Music Education,114,53,61
2014,Fine and Applied Arts,Music Education,11,2,9
2014,Fine and Applied Arts,Music Education,1,1,0
2014,Fine and Applied Arts,Music Education,6,2,4
2014,Fine and Applied Arts,Music Education,44,11,33
2014,Fine and Applied Arts,Music Education,1,0,1
2014,Fine and Applied Arts,Music Education,7,6,1
2014,Fine and Applied Arts,Music Education,105,53,52
2013,Fine and Applied Arts,Music Education,7,2,5
2013,Fine and Applied Arts,Music Education,6,5,1
2013,Fine and Applied Arts,Music Education,1,1,0
2013,Fine and Applied Arts,Music Education,4,3,1
2013,Fine and Applied Arts,Music Education,5,3,2
2013,Fine and Applied Arts,Music Education,45,12,33
2013,Fine and Applied Arts,Music Education,112,54,58
2012,Fine and Applied Arts,Music Education,6,3,3
2012,Fine and Applied Arts,Music Education,7,5,2
2012,Fine and Applied Arts,Music Education,3,3,0
2012,Fine and Applied Arts,Music Education,3,2,1
2012,Fine and Applied Arts,Music Education,35,10,25
2012,Fine and Applied Arts,Music Education,112,54,58
2011,Fine and Applied Arts,Music Education,41,11,30
2011,Fine and Applied Arts,Music Education,4,3,1
2011,Fine and Applied Arts,Music Education,2,2,0
2011,Fine and Applied Arts,Music Education,8,6,2
2011,Fine and Applied Arts,Music Education,128,63,65
2011,Fine and Applied Arts,Music Education,6,5,1
2010,Fine and Applied Arts,Music Education,44,13,31
2010,Fine and Applied Arts,Music Education,3,1,2
2010,Fine and Applied Arts,Music Education,2,2,0
2010,Fine and Applied Arts,Music Education,12,7,5
2010,Fine and Applied Arts,Music Education,138,73,65
2010,Fine and Applied Arts,Music Education,11,8,3
2009,Fine and Applied Arts,Music Education,3,1,2
2009,Fine and Applied Arts,Music Education,57,19,38
2009,Fine and Applied Arts,Music Education,1,1,0
2009,Fine and Applied Arts,Music Education,8,5,3
2009,Fine and Applied Arts,Music Education,154,81,73
2009,Fine and Applied Arts,Music Education,20,11,9
2008,Fine and Applied Arts,Music Education,60,26,34
2008,Fine and Applied Arts,Music Education,4,1,3
2008,Fine and Applied Arts,Music Education,1,0,1
2008,Fine and Applied Arts,Music Education,2,1,1
2008,Fine and Applied Arts,Music Education,9,3,6
2008,Fine and Applied Arts,Music Education,174,90,84
2008,Fine and Applied Arts,Music Education,17,11,6
2007,Fine and Applied Arts,Music Education,4,3,1
2007,Fine and Applied Arts,Music Education,5,1,4
2007,Fine and Applied Arts,Music Education,1,0,1
2007,Fine and Applied Arts,Music Education,58,25,33
2007,Fine and Applied Arts,Music Education,9,5,4
2007,Fine and Applied Arts,Music Education,158,81,77
2007,Fine and Applied Arts,Music Education,15,9,6
2006,Fine and Applied Arts,Music Education,5,3,2
2006,Fine and Applied Arts,Music Education,5,0,5
2006,Fine and Applied Arts,Music Education,60,21,39
2006,Fine and Applied Arts,Music Education,14,10,4
2006,Fine and Applied Arts,Music Education,153,75,78
2006,Fine and Applied Arts,Music Education,16,10,6
2005,Fine and Applied Arts,Music Education,1,0,1
2005,Fine and Applied Arts,Music Education,4,1,3
2005,Fine and Applied Arts,Music Education,61,19,42
2005,Fine and Applied Arts,Music Education,15,10,5
2005,Fine and Applied Arts,Music Education,135,62,73
2005,Fine and Applied Arts,Music Education,11,9,2
2004,Fine and Applied Arts,Music Education,9,6,3
2004,Fine and Applied Arts,Music Education,50,12,38
2004,Fine and Applied Arts,Music Education,120,53,67
2004,Fine and Applied Arts,Music Education,9,2,7
2004,Fine and Applied Arts,Music Education,8,4,4
2004,Fine and Applied Arts,Music Education,12,5,7
1980,Fine and Applied Arts,Music History,4,1,3
1981,Fine and Applied Arts,Music History,6,2,4
1982,Fine and Applied Arts,Music History,5,2,3
1983,Fine and Applied Arts,Music History,5,1,4
1984,Fine and Applied Arts,Music History,3,1,2
1985,Fine and Applied Arts,Music History,2,1,1
1987,Fine and Applied Arts,Music History,4,2,2
1988,Fine and Applied Arts,Music History,3,2,1
1989,Fine and Applied Arts,Music History,3,1,2
1992,Fine and Applied Arts,Music History,2,1,1
1993,Fine and Applied Arts,Music History,3,2,1
1995,Fine and Applied Arts,Music History,2,1,1
1996,Fine and Applied Arts,Music History,3,2,1
1997,Fine and Applied Arts,Music History,7,4,3
1998,Fine and Applied Arts,Music History,5,4,1
1999,Fine and Applied Arts,Music History,4,2,2
2000,Fine and Applied Arts,Music History,7,1,6
2001,Fine and Applied Arts,Music History,9,1,8
2003,Fine and Applied Arts,Music History,7,1,6
2014,Fine and Applied Arts,Music History,3,0,3
2013,Fine and Applied Arts,Music History,2,0,2
2012,Fine and Applied Arts,Music History,3,1,2
2011,Fine and Applied Arts,Music History,5,2,3
2010,Fine and Applied Arts,Music History,8,3,5
2009,Fine and Applied Arts,Music History,7,3,4
2008,Fine and Applied Arts,Music History,2,1,1
2007,Fine and Applied Arts,Music History,2,1,1
2006,Fine and Applied Arts,Music History,2,1,1
2005,Fine and Applied Arts,Music History,1,0,1
2004,Fine and Applied Arts,Music History,4,1,3
1980,Fine and Applied Arts,MUSIC-COMP,19,16,3
1981,Fine and Applied Arts,MUSIC-COMP,18,13,5
1982,Fine and Applied Arts,MUSIC-COMP,13,10,3
1983,Fine and Applied Arts,MUSIC-COMP,10,8,2
1984,Fine and Applied Arts,MUSIC-COMP,13,11,2
1985,Fine and Applied Arts,MUSIC-COMP,6,4,2
1986,Fine and Applied Arts,MUSIC-COMP,5,4,1
1988,Fine and Applied Arts,MUSIC-COMP,12,8,4
1989,Fine and Applied Arts,MUSIC-COMP,11,8,3
1990,Fine and Applied Arts,MUSIC-COMP,11,8,3
1991,Fine and Applied Arts,MUSIC-COMP,15,12,3
1992,Fine and Applied Arts,MUSIC-COMP,19,14,5
1993,Fine and Applied Arts,MUSIC-COMP,9,7,2
1994,Fine and Applied Arts,MUSIC-COMP,14,11,3
1995,Fine and Applied Arts,MUSIC-COMP,17,16,1
1998,Fine and Applied Arts,MUSIC-COMP,10,8,2
1999,Fine and Applied Arts,MUSIC-COMP,12,10,2
2000,Fine and Applied Arts,MUSIC-COMP,8,7,1
2001,Fine and Applied Arts,MUSIC-COMP,11,10,1
2002,Fine and Applied Arts,MUSIC-COMP,17,15,2
2003,Fine and Applied Arts,MUSIC-COMP,13,12,1
1980,Fine and Applied Arts,MUSIC-INST,105,54,51
1981,Fine and Applied Arts,MUSIC-INST,105,50,55
1982,Fine and Applied Arts,MUSIC-INST,106,53,53
1983,Fine and Applied Arts,MUSIC-INST,93,41,52
1984,Fine and Applied Arts,MUSIC-INST,100,40,60
1985,Fine and Applied Arts,MUSIC-INST,92,40,52
1986,Fine and Applied Arts,MUSIC-INST,79,32,47
1987,Fine and Applied Arts,MUSIC-INST,81,34,47
1988,Fine and Applied Arts,MUSIC-INST,102,38,64
1989,Fine and Applied Arts,MUSIC-INST,90,34,56
1990,Fine and Applied Arts,MUSIC-INST,83,35,48
1991,Fine and Applied Arts,MUSIC-INST,87,40,47
1992,Fine and Applied Arts,MUSIC-INST,86,32,54
1993,Fine and Applied Arts,MUSIC-INST,87,32,55
1994,Fine and Applied Arts,MUSIC-INST,95,33,62
1995,Fine and Applied Arts,MUSIC-INST,106,41,65
1996,Fine and Applied Arts,MUSIC-INST,110,40,70
1997,Fine and Applied Arts,MUSIC-INST,107,41,66
1998,Fine and Applied Arts,MUSIC-INST,117,39,78
1999,Fine and Applied Arts,MUSIC-INST,109,37,72
2000,Fine and Applied Arts,MUSIC-INST,103,44,59
2001,Fine and Applied Arts,MUSIC-INST,90,47,43
2002,Fine and Applied Arts,MUSIC-INST,86,51,35
2003,Fine and Applied Arts,MUSIC-INST,104,56,48
1989,Fine and Applied Arts,MUSIC-OPEN,3,1,2
1990,Fine and Applied Arts,MUSIC-OPEN,4,2,2
1991,Fine and Applied Arts,MUSIC-OPEN,3,2,1
1992,Fine and Applied Arts,MUSIC-OPEN,5,2,3
1993,Fine and Applied Arts,MUSIC-OPEN,4,1,3
1994,Fine and Applied Arts,MUSIC-OPEN,3,2,1
1996,Fine and Applied Arts,MUSIC-OPEN,2,1,1
2001,Fine and Applied Arts,MUSIC-OPEN,3,2,1
2002,Fine and Applied Arts,MUSIC-OPEN,5,2,3
2003,Fine and Applied Arts,MUSIC-OPEN,7,6,1
1985,Fine and Applied Arts,MUSIC(AMS),58,37,21
1986,Fine and Applied Arts,MUSIC(AMS),74,40,34
1987,Fine and Applied Arts,MUSIC(AMS),75,41,34
1988,Fine and Applied Arts,MUSIC(AMS),67,38,29
1989,Fine and Applied Arts,MUSIC(AMS),60,36,24
1990,Fine and Applied Arts,MUSIC(AMS),60,35,25
1991,Fine and Applied Arts,MUSIC(AMS),81,44,37
1992,Fine and Applied Arts,MUSIC(AMS),87,53,34
1993,Fine and Applied Arts,MUSIC(AMS),76,49,27
1994,Fine and Applied Arts,MUSIC(AMS),78,45,33
1995,Fine and Applied Arts,MUSIC(AMS),90,48,42
1996,Fine and Applied Arts,MUSIC(AMS),104,49,55
1997,Fine and Applied Arts,MUSIC(AMS),100,50,50
1998,Fine and Applied Arts,MUSIC(AMS),96,46,50
1999,Fine and Applied Arts,MUSIC(AMS),87,43,44
2000,Fine and Applied Arts,MUSIC(AMS),91,50,41
2001,Fine and Applied Arts,MUSIC(AMS),115,60,55
2002,Fine and Applied Arts,MUSIC(AMS),108,46,62
2003,Fine and Applied Arts,MUSIC(AMS),116,52,64
2018,Fine and Applied Arts,Musicology,1,0,1
2018,Fine and Applied Arts,Musicology,17,11,6
2018,Fine and Applied Arts,Musicology,1,0,1
2017,Fine and Applied Arts,Musicology,2,0,2
2017,Fine and Applied Arts,Musicology,20,12,8
2017,Fine and Applied Arts,Musicology,1,0,1
2016,Fine and Applied Arts,Musicology,4,0,4
2016,Fine and Applied Arts,Musicology,17,9,8
2016,Fine and Applied Arts,Musicology,1,0,1
2015,Fine and Applied Arts,Musicology,3,1,2
2015,Fine and Applied Arts,Musicology,19,9,10
2014,Fine and Applied Arts,Musicology,15,10,5
2013,Fine and Applied Arts,Musicology,22,14,8
2012,Fine and Applied Arts,Musicology,19,10,9
2011,Fine and Applied Arts,Musicology,19,9,10
2010,Fine and Applied Arts,Musicology,14,7,7
2009,Fine and Applied Arts,Musicology,18,9,9
2008,Fine and Applied Arts,Musicology,19,8,11
2007,Fine and Applied Arts,Musicology,20,10,10
2006,Fine and Applied Arts,Musicology,9,3,6
2005,Fine and Applied Arts,Musicology,10,5,5
2004,Fine and Applied Arts,Musicology,19,12,7
1998,ACES,Natural Res & Env Sciences,2,1,1
1999,ACES,Natural Res & Env Sciences,3,2,1
2002,ACES,Natural Res & Env Sciences,3,2,1
2003,ACES,Natural Res & Env Sciences,67,42,25
2018,ACES,Natural Res & Env Sciences,47,22,25
2018,ACES,Natural Res & Env Sciences,31,12,19
2018,ACES,Natural Res & Env Sciences,40,24,16
2017,ACES,Natural Res & Env Sciences,46,17,29
2017,ACES,Natural Res & Env Sciences,34,13,21
2017,ACES,Natural Res & Env Sciences,40,25,15
2016,ACES,Natural Res & Env Sciences,47,18,29
2016,ACES,Natural Res & Env Sciences,2,0,2
2016,ACES,Natural Res & Env Sciences,30,20,10
2015,ACES,Natural Res & Env Sciences,2,0,2
2015,ACES,Natural Res & Env Sciences,26,15,11
2015,ACES,Natural Res & Env Sciences,55,31,24
2014,ACES,Natural Res & Env Sciences,1,0,1
2014,ACES,Natural Res & Env Sciences,32,22,10
2014,ACES,Natural Res & Env Sciences,51,33,18
2013,ACES,Natural Res & Env Sciences,2,0,2
2013,ACES,Natural Res & Env Sciences,29,21,8
2013,ACES,Natural Res & Env Sciences,48,34,14
2012,ACES,Natural Res & Env Sciences,3,0,3
2012,ACES,Natural Res & Env Sciences,26,19,7
2012,ACES,Natural Res & Env Sciences,51,34,17
2011,ACES,Natural Res & Env Sciences,47,24,23
2011,ACES,Natural Res & Env Sciences,1,0,1
2011,ACES,Natural Res & Env Sciences,30,21,9
2010,ACES,Natural Res & Env Sciences,45,26,19
2010,ACES,Natural Res & Env Sciences,25,16,9
2009,ACES,Natural Res & Env Sciences,1,1,0
2009,ACES,Natural Res & Env Sciences,1,1,0
2009,ACES,Natural Res & Env Sciences,33,19,14
2009,ACES,Natural Res & Env Sciences,53,31,22
2008,ACES,Natural Res & Env Sciences,1,1,0
2008,ACES,Natural Res & Env Sciences,1,1,0
2008,ACES,Natural Res & Env Sciences,35,19,16
2008,ACES,Natural Res & Env Sciences,54,29,25
2007,ACES,Natural Res & Env Sciences,3,1,2
2007,ACES,Natural Res & Env Sciences,36,19,17
2007,ACES,Natural Res & Env Sciences,52,27,25
2006,ACES,Natural Res & Env Sciences,4,2,2
2006,ACES,Natural Res & Env Sciences,36,20,16
2006,ACES,Natural Res & Env Sciences,59,25,34
2005,ACES,Natural Res & Env Sciences,1,0,1
2005,ACES,Natural Res & Env Sciences,5,3,2
2005,ACES,Natural Res & Env Sciences,32,20,12
2005,ACES,Natural Res & Env Sciences,56,25,31
2004,ACES,Natural Res & Env Sciences,63,29,34
2004,ACES,Natural Res & Env Sciences,1,1,0
2004,ACES,Natural Res & Env Sciences,7,5,2
2004,ACES,Natural Res & Env Sciences,44,26,18
1998,ACES,Natural Resrcs & Environ Sci,98,60,38
1999,ACES,Natural Resrcs & Environ Sci,112,69,43
2000,ACES,Natural Resrcs & Environ Sci,108,65,43
2001,ACES,Natural Resrcs & Environ Sci,133,74,59
2002,ACES,Natural Resrcs & Environ Sci,143,78,65
2003,ACES,Natural Resrcs & Environ Sci,137,81,56
2018,ACES,Natural Resrcs & Environ Sci,59,22,37
2018,ACES,Natural Resrcs & Environ Sci,42,26,16
2018,ACES,Natural Resrcs & Environ Sci,2,1,1
2018,ACES,Natural Resrcs & Environ Sci,50,15,35
2018,ACES,Natural Resrcs & Environ Sci,68,30,38
2018,ACES,Natural Resrcs & Environ Sci,20,4,16
2017,ACES,Natural Resrcs & Environ Sci,60,38,22
2017,ACES,Natural Resrcs & Environ Sci,2,1,1
2017,ACES,Natural Resrcs & Environ Sci,56,23,33
2017,ACES,Natural Resrcs & Environ Sci,1,0,1
2017,ACES,Natural Resrcs & Environ Sci,80,30,50
2017,ACES,Natural Resrcs & Environ Sci,29,6,23
2016,ACES,Natural Resrcs & Environ Sci,46,28,18
2016,ACES,Natural Resrcs & Environ Sci,4,1,3
2016,ACES,Natural Resrcs & Environ Sci,63,28,35
2016,ACES,Natural Resrcs & Environ Sci,80,33,47
2016,ACES,Natural Resrcs & Environ Sci,33,15,18
2015,ACES,Natural Resrcs & Environ Sci,4,1,3
2015,ACES,Natural Resrcs & Environ Sci,52,34,18
2015,ACES,Natural Resrcs & Environ Sci,32,14,18
2015,ACES,Natural Resrcs & Environ Sci,73,33,40
2015,ACES,Natural Resrcs & Environ Sci,74,42,32
2014,ACES,Natural Resrcs & Environ Sci,1,1,0
2014,ACES,Natural Resrcs & Environ Sci,5,3,2
2014,ACES,Natural Resrcs & Environ Sci,53,30,23
2014,ACES,Natural Resrcs & Environ Sci,22,9,13
2014,ACES,Natural Resrcs & Environ Sci,78,35,43
2014,ACES,Natural Resrcs & Environ Sci,73,37,36
2013,ACES,Natural Resrcs & Environ Sci,16,12,4
2013,ACES,Natural Resrcs & Environ Sci,1,1,0
2013,ACES,Natural Resrcs & Environ Sci,1,0,1
2013,ACES,Natural Resrcs & Environ Sci,20,10,10
2013,ACES,Natural Resrcs & Environ Sci,50,27,23
2013,ACES,Natural Resrcs & Environ Sci,71,40,31
2013,ACES,Natural Resrcs & Environ Sci,80,38,42
2012,ACES,Natural Resrcs & Environ Sci,1,1,0
2012,ACES,Natural Resrcs & Environ Sci,21,16,5
2012,ACES,Natural Resrcs & Environ Sci,2,0,2
2012,ACES,Natural Resrcs & Environ Sci,2,1,1
2012,ACES,Natural Resrcs & Environ Sci,2,1,1
2012,ACES,Natural Resrcs & Environ Sci,77,43,34
2012,ACES,Natural Resrcs & Environ Sci,38,23,15
2012,ACES,Natural Resrcs & Environ Sci,25,11,14
2012,ACES,Natural Resrcs & Environ Sci,73,30,43
2011,ACES,Natural Resrcs & Environ Sci,1,1,0
2011,ACES,Natural Resrcs & Environ Sci,42,21,21
2011,ACES,Natural Resrcs & Environ Sci,18,9,9
2011,ACES,Natural Resrcs & Environ Sci,3,3,0
2011,ACES,Natural Resrcs & Environ Sci,7,6,1
2011,ACES,Natural Resrcs & Environ Sci,4,3,1
2011,ACES,Natural Resrcs & Environ Sci,6,2,4
2011,ACES,Natural Resrcs & Environ Sci,56,27,29
2011,ACES,Natural Resrcs & Environ Sci,77,36,41
2011,ACES,Natural Resrcs & Environ Sci,21,14,7
2010,ACES,Natural Resrcs & Environ Sci,21,14,7
2010,ACES,Natural Resrcs & Environ Sci,28,15,13
2010,ACES,Natural Resrcs & Environ Sci,7,6,1
2010,ACES,Natural Resrcs & Environ Sci,18,12,6
2010,ACES,Natural Resrcs & Environ Sci,10,6,4
2010,ACES,Natural Resrcs & Environ Sci,18,5,13
2010,ACES,Natural Resrcs & Environ Sci,42,19,23
2010,ACES,Natural Resrcs & Environ Sci,13,9,4
2010,ACES,Natural Resrcs & Environ Sci,30,16,14
2009,ACES,Natural Resrcs & Environ Sci,18,15,3
2009,ACES,Natural Resrcs & Environ Sci,58,27,31
2009,ACES,Natural Resrcs & Environ Sci,19,9,10
2009,ACES,Natural Resrcs & Environ Sci,46,23,23
2009,ACES,Natural Resrcs & Environ Sci,54,25,29
2008,ACES,Natural Resrcs & Environ Sci,1,0,1
2008,ACES,Natural Resrcs & Environ Sci,60,33,26
2008,ACES,Natural Resrcs & Environ Sci,42,19,23
2008,ACES,Natural Resrcs & Environ Sci,17,13,4
2008,ACES,Natural Resrcs & Environ Sci,46,17,29
2008,ACES,Natural Resrcs & Environ Sci,11,5,6
2007,ACES,Natural Resrcs & Environ Sci,1,0,1
2007,ACES,Natural Resrcs & Environ Sci,1,1,0
2007,ACES,Natural Resrcs & Environ Sci,82,47,34
2007,ACES,Natural Resrcs & Environ Sci,49,21,28
2007,ACES,Natural Resrcs & Environ Sci,15,11,4
2007,ACES,Natural Resrcs & Environ Sci,38,10,28
2007,ACES,Natural Resrcs & Environ Sci,11,5,6
2006,ACES,Natural Resrcs & Environ Sci,4,3,1
2006,ACES,Natural Resrcs & Environ Sci,2,2,0
2006,ACES,Natural Resrcs & Environ Sci,1,0,1
2006,ACES,Natural Resrcs & Environ Sci,80,56,24
2006,ACES,Natural Resrcs & Environ Sci,14,10,4
2006,ACES,Natural Resrcs & Environ Sci,12,6,6
2006,ACES,Natural Resrcs & Environ Sci,42,12,30
2006,ACES,Natural Resrcs & Environ Sci,56,32,24
2005,ACES,Natural Resrcs & Environ Sci,10,7,3
2005,ACES,Natural Resrcs & Environ Sci,2,0,2
2005,ACES,Natural Resrcs & Environ Sci,12,6,6
2005,ACES,Natural Resrcs & Environ Sci,6,2,4
2005,ACES,Natural Resrcs & Environ Sci,73,54,19
2005,ACES,Natural Resrcs & Environ Sci,18,16,2
2005,ACES,Natural Resrcs & Environ Sci,31,10,21
2005,ACES,Natural Resrcs & Environ Sci,44,27,17
2004,ACES,Natural Resrcs & Environ Sci,28,16,12
2004,ACES,Natural Resrcs & Environ Sci,17,5,12
2004,ACES,Natural Resrcs & Environ Sci,6,2,4
2004,ACES,Natural Resrcs & Environ Sci,63,42,21
2004,ACES,Natural Resrcs & Environ Sci,14,13,1
2004,ACES,Natural Resrcs & Environ Sci,29,12,17
2004,ACES,Natural Resrcs & Environ Sci,34,19,15
2004,ACES,Natural Resrcs & Environ Sci,9,4,5
2004,ACES,Natural Resrcs & Environ Sci,1,0,1
2004,ACES,Natural Resrcs & Environ Sci,1,1,0
2018,LAS,Neuroscience,54,22,32
2017,LAS,Neuroscience,1,1,0
2017,LAS,Neuroscience,58,24,34
2016,LAS,Neuroscience,3,2,1
2016,LAS,Neuroscience,66,31,35
2015,LAS,Neuroscience,67,32,35
2014,LAS,Neuroscience,1,0,1
2014,LAS,Neuroscience,61,32,29
2013,LAS,Neuroscience,48,23,25
2012,LAS,Neuroscience,55,27,28
2011,LAS,Neuroscience,60,27,33
2010,LAS,Neuroscience,58,24,34
2009,LAS,Neuroscience,50,20,30
2008,LAS,Neuroscience,54,21,33
2007,LAS,Neuroscience,52,21,31
2006,LAS,Neuroscience,58,22,36
2005,LAS,Neuroscience,59,26,33
2004,LAS,Neuroscience,61,30,31
1992,LAS,Neuroscience,25,16,9
1993,LAS,Neuroscience,28,22,6
1994,LAS,Neuroscience,30,24,6
1995,LAS,Neuroscience,33,25,8
1996,LAS,Neuroscience,34,26,8
1997,LAS,Neuroscience,40,31,9
1998,LAS,Neuroscience,45,36,9
1999,LAS,Neuroscience,41,32,9
2000,LAS,Neuroscience,40,29,11
2001,LAS,Neuroscience,42,27,15
2002,LAS,Neuroscience,46,27,19
2003,LAS,Neuroscience,53,32,21
2018,Fine and Applied Arts,New Media,29,7,22
2017,Fine and Applied Arts,New Media,20,7,13
2016,Fine and Applied Arts,New Media,19,9,10
2015,Fine and Applied Arts,New Media,17,10,7
2014,Fine and Applied Arts,New Media,17,11,6
2013,Fine and Applied Arts,New Media,20,11,9
2012,Fine and Applied Arts,New Media,18,8,10
2011,Fine and Applied Arts,New Media,24,8,16
2010,Fine and Applied Arts,New Media,25,8,17
2009,Fine and Applied Arts,New Media,22,10,12
2008,Fine and Applied Arts,New Media,15,8,7
2017,Media,News-Editorial,5,1,4
2016,Media,News-Editorial,37,11,26
2015,Media,News-Editorial,77,24,53
2014,Media,News-Editorial,120,34,86
2013,Media,News-Editorial,161,50,111
2012,Media,News-Editorial,168,49,119
2011,Media,News-Editorial,169,46,123
2010,Media,News-Editorial,181,55,126
2009,Media,News-Editorial,215,64,151
2008,Media,News-Editorial,219,64,155
2007,Media,News-Editorial,143,46,97
2006,Media,News-Editorial,144,55,89
2005,Media,News-Editorial,125,48,77
2004,Media,News-Editorial,128,47,81
1981,Media,News-Editorial,122,45,77
1982,Media,News-Editorial,125,54,71
1983,Media,News-Editorial,148,67,81
1984,Media,News-Editorial,152,61,91
1985,Media,News-Editorial,145,58,87
1986,Media,News-Editorial,136,50,86
1987,Media,News-Editorial,113,45,68
1988,Media,News-Editorial,121,45,76
1989,Media,News-Editorial,128,52,76
1990,Media,News-Editorial,123,57,66
1991,Media,News-Editorial,109,49,60
1992,Media,News-Editorial,111,48,63
1993,Media,News-Editorial,99,42,57
1994,Media,News-Editorial,82,33,49
1995,Media,News-Editorial,90,42,48
1996,Media,News-Editorial,92,42,50
1997,Media,News-Editorial,99,48,51
1998,Media,News-Editorial,108,44,64
1999,Media,News-Editorial,124,42,82
2000,Media,News-Editorial,111,29,82
2001,Media,News-Editorial,120,37,83
2002,Media,News-Editorial,116,35,81
2003,Media,News-Editorial,110,36,74
2001,ACES,Nondegree,17,9,8
2002,ACES,Nondegree,13,7,6
2003,ACES,Nondegree,17,7,10
2018,ACES,Nondegree,81,40,41
2017,ACES,Nondegree,96,49,47
2016,ACES,Nondegree,115,62,53
2015,ACES,Nondegree,119,68,51
2014,ACES,Nondegree,136,76,60
2013,ACES,Nondegree,119,73,46
2012,ACES,Nondegree,124,74,50
2011,ACES,Nondegree,87,51,36
2010,ACES,Nondegree,75,36,39
2009,ACES,Nondegree,48,22,26
2008,ACES,Nondegree,30,15,15
2007,ACES,Nondegree,13,3,10
2006,ACES,Nondegree,13,5,8
2005,ACES,Nondegree,11,5,6
2004,ACES,Nondegree,19,6,13
2004,ACES,Nondegree,1,0,1
2018,Applied Health Sciences,Nondegree,31,15,16
2018,Applied Health Sciences,Nondegree,7,1,6
2017,Applied Health Sciences,Nondegree,30,18,12
2017,Applied Health Sciences,Nondegree,16,6,10
2016,Applied Health Sciences,Nondegree,29,17,12
2015,Applied Health Sciences,Nondegree,21,10,11
2014,Applied Health Sciences,Nondegree,6,4,2
2013,Applied Health Sciences,Nondegree,3,2,1
2012,Applied Health Sciences,Nondegree,7,2,5
2011,Applied Health Sciences,Nondegree,12,7,5
2010,Applied Health Sciences,Nondegree,8,3,5
2009,Applied Health Sciences,Nondegree,4,2,2
2007,Applied Health Sciences,Nondegree,3,1,2
2006,Applied Health Sciences,Nondegree,5,3,2
2005,Applied Health Sciences,Nondegree,3,3,0
2004,Applied Health Sciences,Nondegree,2,0,2
1988,Aviation,Nondegree,12,11,1
1989,Aviation,Nondegree,13,12,1
1990,Aviation,Nondegree,18,17,1
1991,Aviation,Nondegree,19,13,6
1992,Aviation,Nondegree,17,14,3
1995,Aviation,Nondegree,9,8,1
1998,Aviation,Nondegree,7,5,2
1999,Aviation,Nondegree,13,12,1
2000,Aviation,Nondegree,10,9,1
2002,Aviation,Nondegree,8,6,2
2013,Aviation,Nondegree,1,1,0
2011,Aviation,Nondegree,1,1,0
2010,Aviation,Nondegree,1,1,0
2009,Aviation,Nondegree,1,1,0
2008,Aviation,Nondegree,1,1,0
2006,Aviation,Nondegree,2,2,0
2005,Aviation,Nondegree,1,1,0
2004,Aviation,Nondegree,1,1,0
2018,Business,Nondegree,97,50,47
2017,Business,Nondegree,114,67,47
2016,Business,Nondegree,98,54,44
2015,Business,Nondegree,78,45,33
2014,Business,Nondegree,73,51,22
2013,Business,Nondegree,72,43,29
2012,Business,Nondegree,83,53,30
2011,Business,Nondegree,91,57,34
2010,Business,Nondegree,61,39,22
2009,Business,Nondegree,42,28,14
2008,Business,Nondegree,37,24,13
2007,Business,Nondegree,26,18,8
2006,Business,Nondegree,32,19,13
2005,Business,Nondegree,34,18,16
2004,Business,Nondegree,33,21,12
2018,Education,Nondegree,5,1,4
2017,Education,Nondegree,4,0,4
2016,Education,Nondegree,7,1,6
2015,Education,Nondegree,6,1,5
2014,Education,Nondegree,10,2,8
2013,Education,Nondegree,3,0,3
2012,Education,Nondegree,6,0,6
2011,Education,Nondegree,9,3,6
2010,Education,Nondegree,12,3,9
2009,Education,Nondegree,2,0,2
2007,Education,Nondegree,3,0,3
2005,Education,Nondegree,6,1,5
2018,Engineering,Nondegree,181,132,49
2017,Engineering,Nondegree,184,148,36
2016,Engineering,Nondegree,194,155,39
2015,Engineering,Nondegree,218,172,46
2014,Engineering,Nondegree,228,176,52
2013,Engineering,Nondegree,207,173,34
2012,Engineering,Nondegree,228,184,43
2011,Engineering,Nondegree,207,162,45
2010,Engineering,Nondegree,201,169,32
2009,Engineering,Nondegree,196,154,42
2008,Engineering,Nondegree,135,110,25
2007,Engineering,Nondegree,106,87,19
2006,Engineering,Nondegree,104,92,12
2005,Engineering,Nondegree,83,65,18
2004,Engineering,Nondegree,78,62,16
2018,Fine and Applied Arts,Nondegree,38,17,21
2017,Fine and Applied Arts,Nondegree,40,22,18
2016,Fine and Applied Arts,Nondegree,32,16,16
2015,Fine and Applied Arts,Nondegree,30,15,15
2014,Fine and Applied Arts,Nondegree,24,9,15
2013,Fine and Applied Arts,Nondegree,34,14,20
2012,Fine and Applied Arts,Nondegree,22,6,16
2011,Fine and Applied Arts,Nondegree,33,14,19
2010,Fine and Applied Arts,Nondegree,21,8,13
2009,Fine and Applied Arts,Nondegree,30,15,15
2008,Fine and Applied Arts,Nondegree,22,13,9
2007,Fine and Applied Arts,Nondegree,23,12,11
2006,Fine and Applied Arts,Nondegree,30,14,16
2005,Fine and Applied Arts,Nondegree,29,16,13
2004,Fine and Applied Arts,Nondegree,25,15,10
2004,Fine and Applied Arts,Nondegree,4,1,3
2018,Graduate,Nondegree,10,6,4
2018,Graduate,Nondegree,5,5,0
2017,Graduate,Nondegree,23,11,12
2016,Graduate,Nondegree,38,19,19
2015,Graduate,Nondegree,46,25,21
2014,Graduate,Nondegree,42,26,16
2013,Graduate,Nondegree,44,24,20
2012,Graduate,Nondegree,39,22,17
2011,Graduate,Nondegree,27,14,13
2010,Graduate,Nondegree,14,5,9
2009,Graduate,Nondegree,4,2,2
2008,Graduate,Nondegree,4,3,1
2007,Graduate,Nondegree,2,1,1
2006,Graduate,Nondegree,2,0,2
2005,Graduate,Nondegree,4,0,4
2004,Graduate,Nondegree,3,0,3
2018,LAS,Nondegree,149,76,73
2017,LAS,Nondegree,220,121,99
2016,LAS,Nondegree,202,90,112
2015,LAS,Nondegree,213,98,115
2014,LAS,Nondegree,211,109,102
2013,LAS,Nondegree,183,87,96
2012,LAS,Nondegree,189,93,96
2011,LAS,Nondegree,176,84,92
2010,LAS,Nondegree,164,82,82
2009,LAS,Nondegree,158,67,91
2008,LAS,Nondegree,146,67,79
2007,LAS,Nondegree,129,60,69
2006,LAS,Nondegree,135,62,73
2005,LAS,Nondegree,130,68,60
2004,LAS,Nondegree,138,55,83
2004,LN,Nondegree,3,0,3
2004,LN,Nondegree,1,1,0
2018,Media,Nondegree,26,13,13
2017,Media,Nondegree,21,9,12
2016,Media,Nondegree,21,9,12
2015,Media,Nondegree,22,9,13
2014,Media,Nondegree,20,10,10
2013,Media,Nondegree,22,12,10
2012,Media,Nondegree,7,5,2
2011,Media,Nondegree,4,3,1
2010,Media,Nondegree,6,3,3
2009,Media,Nondegree,6,1,5
2008,Media,Nondegree,1,0,1
2007,Media,Nondegree,1,0,1
2006,Media,Nondegree,2,0,2
2005,Media,Nondegree,2,1,1
2004,Media,Nondegree,2,1,1
2018,NB,Nondegree,3,0,2
2017,NB,Nondegree,4,1,3
2016,NB,Nondegree,12,10,2
2015,NB,Nondegree,1,1,0
2014,NB,Nondegree,1,0,1
2010,NB,Nondegree,2,2,0
2006,NB,Nondegree,1,0,1
2018,LN,Nondegree-CE,305,121,182
2018,LN,Nondegree-CE,94,49,40
2017,LN,Nondegree-CE,272,114,154
2017,LN,Nondegree-CE,27,12,13
2016,LN,Nondegree-CE,46,17,29
2015,LN,Nondegree-CE,1,1,0
2015,LN,Nondegree-CE,51,15,36
2014,LN,Nondegree-CE,47,12,35
2013,LN,Nondegree-CE,57,18,39
2012,LN,Nondegree-CE,57,16,41
2011,LN,Nondegree-CE,2,1,1
2011,LN,Nondegree-CE,102,29,73
2010,LN,Nondegree-CE,1,1,0
2010,LN,Nondegree-CE,100,37,63
2009,LN,Nondegree-CE,1,0,1
2009,LN,Nondegree-CE,100,31,69
2008,LN,Nondegree-CE,1,1,0
2008,LN,Nondegree-CE,71,23,48
2007,LN,Nondegree-CE,1,1,0
2007,LN,Nondegree-CE,82,28,54
2006,LN,Nondegree-CE,70,20,50
2005,LN,Nondegree-CE,3,2,1
2005,LN,Nondegree-CE,83,27,56
2004,LN,Nondegree-CE,65,18,45
1998,ACES,NRES - SOILS,5,2,3
1999,ACES,NRES - SOILS,3,1,2
2000,ACES,NRES - SOILS,3,1,2
1997,ACES,NRES-BIOL SCI,30,12,18
1998,ACES,NRES-BIOL SCI,117,54,63
1999,ACES,NRES-BIOL SCI,137,64,73
2000,ACES,NRES-BIOL SCI,91,44,47
2000,ACES,NRES-BIOL SCI,37,20,17
2001,ACES,NRES-BIOL SCI,45,25,20
2001,ACES,NRES-BIOL SCI,59,29,30
2002,ACES,NRES-BIOL SCI,15,11,4
2002,ACES,NRES-BIOL SCI,68,37,31
2003,ACES,NRES-BIOL SCI,53,31,22
2000,ACES,NRES-ENV S W,8,6,2
2001,ACES,NRES-ENV S W,11,7,4
2002,ACES,NRES-ENV S W,27,15,12
2003,ACES,NRES-ENV S W,14,6,8
2001,ACES,NRES-F & W CONS,26,17,9
2002,ACES,NRES-F & W CONS,41,28,13
2003,ACES,NRES-F & W CONS,35,22,13
1997,ACES,NRES-SOC SCI,9,6,3
1998,ACES,NRES-SOC SCI,36,16,20
1999,ACES,NRES-SOC SCI,49,24,25
2000,ACES,NRES-SOC SCI,43,17,26
2000,ACES,NRES-SOC SCI,21,7,14
2001,ACES,NRES-SOC SCI,27,11,16
2001,ACES,NRES-SOC SCI,52,25,27
2002,ACES,NRES-SOC SCI,9,5,4
2002,ACES,NRES-SOC SCI,56,23,33
2003,ACES,NRES-SOC SCI,6,1,5
2003,ACES,NRES-SOC SCI,33,17,16
1980,Engineering,Nuclear Engineering,115,106,9
1981,Engineering,Nuclear Engineering,127,116,11
1981,Engineering,Nuclear Engineering,5,4,1
1981,Engineering,Nuclear Engineering,64,63,1
1982,Engineering,Nuclear Engineering,110,98,12
1982,Engineering,Nuclear Engineering,72,70,2
1983,Engineering,Nuclear Engineering,83,76,7
1983,Engineering,Nuclear Engineering,61,58,3
1984,Engineering,Nuclear Engineering,83,75,8
1984,Engineering,Nuclear Engineering,55,52,3
1985,Engineering,Nuclear Engineering,87,76,11
1985,Engineering,Nuclear Engineering,50,48,2
1986,Engineering,Nuclear Engineering,92,82,10
1986,Engineering,Nuclear Engineering,58,56,2
1987,Engineering,Nuclear Engineering,89,79,10
1987,Engineering,Nuclear Engineering,56,52,4
1988,Engineering,Nuclear Engineering,96,83,13
1988,Engineering,Nuclear Engineering,4,3,1
1988,Engineering,Nuclear Engineering,55,50,5
1989,Engineering,Nuclear Engineering,108,99,9
1989,Engineering,Nuclear Engineering,5,4,1
1989,Engineering,Nuclear Engineering,2,1,1
1989,Engineering,Nuclear Engineering,63,54,9
1990,Engineering,Nuclear Engineering,101,89,12
1990,Engineering,Nuclear Engineering,3,2,1
1990,Engineering,Nuclear Engineering,60,51,9
1991,Engineering,Nuclear Engineering,111,97,14
1991,Engineering,Nuclear Engineering,69,57,12
1992,Engineering,Nuclear Engineering,103,96,7
1992,Engineering,Nuclear Engineering,59,46,13
1993,Engineering,Nuclear Engineering,93,84,9
1993,Engineering,Nuclear Engineering,56,41,15
1994,Engineering,Nuclear Engineering,69,61,8
1994,Engineering,Nuclear Engineering,56,44,12
1995,Engineering,Nuclear Engineering,58,50,8
1995,Engineering,Nuclear Engineering,49,41,8
1996,Engineering,Nuclear Engineering,55,46,9
1996,Engineering,Nuclear Engineering,49,41,8
1997,Engineering,Nuclear Engineering,45,39,6
1997,Engineering,Nuclear Engineering,45,37,8
1998,Engineering,Nuclear Engineering,39,34,5
1998,Engineering,Nuclear Engineering,46,37,9
1999,Engineering,Nuclear Engineering,39,34,5
1999,Engineering,Nuclear Engineering,45,37,8
2000,Engineering,Nuclear Engineering,41,34,7
2000,Engineering,Nuclear Engineering,46,39,7
2001,Engineering,Nuclear Engineering,41,37,4
2001,Engineering,Nuclear Engineering,41,34,7
2002,Engineering,Nuclear Engineering,48,37,11
2002,Engineering,Nuclear Engineering,49,40,9
2003,Engineering,Nuclear Engineering,74,61,13
2003,Engineering,Nuclear Engineering,52,42,10
2017,Engineering,Nuclear Engineering,2,2,0
2016,Engineering,Nuclear Engineering,2,2,0
2015,Engineering,Nuclear Engineering,3,2,1
2014,Engineering,Nuclear Engineering,5,4,1
2013,Engineering,Nuclear Engineering,5,4,1
2013,Engineering,Nuclear Engineering,1,1,0
2013,Engineering,Nuclear Engineering,8,6,2
2012,Engineering,Nuclear Engineering,10,8,2
2012,Engineering,Nuclear Engineering,3,3,0
2012,Engineering,Nuclear Engineering,1,0,1
2012,Engineering,Nuclear Engineering,12,10,2
2011,Engineering,Nuclear Engineering,3,3,0
2011,Engineering,Nuclear Engineering,8,7,1
2011,Engineering,Nuclear Engineering,15,12,3
2011,Engineering,Nuclear Engineering,33,27,6
2010,Engineering,Nuclear Engineering,8,5,3
2010,Engineering,Nuclear Engineering,30,25,5
2010,Engineering,Nuclear Engineering,11,11,0
2010,Engineering,Nuclear Engineering,18,17,1
2010,Engineering,Nuclear Engineering,55,47,8
2009,Engineering,Nuclear Engineering,9,7,2
2009,Engineering,Nuclear Engineering,2,2,0
2009,Engineering,Nuclear Engineering,10,10,0
2009,Engineering,Nuclear Engineering,26,21,5
2009,Engineering,Nuclear Engineering,33,31,2
2009,Engineering,Nuclear Engineering,37,31,6
2008,Engineering,Nuclear Engineering,8,8,0
2008,Engineering,Nuclear Engineering,12,9,3
2008,Engineering,Nuclear Engineering,22,20,2
2008,Engineering,Nuclear Engineering,15,12,3
2008,Engineering,Nuclear Engineering,65,58,7
2008,Engineering,Nuclear Engineering,52,45,7
2007,Engineering,Nuclear Engineering,16,12,4
2007,Engineering,Nuclear Engineering,105,86,19
2007,Engineering,Nuclear Engineering,50,40,10
2006,Engineering,Nuclear Engineering,14,10,4
2006,Engineering,Nuclear Engineering,99,88,11
2006,Engineering,Nuclear Engineering,49,41,8
2005,Engineering,Nuclear Engineering,16,13,3
2005,Engineering,Nuclear Engineering,95,84,11
2005,Engineering,Nuclear Engineering,48,39,9
2004,Engineering,Nuclear Engineering,98,84,14
2004,Engineering,Nuclear Engineering,12,10,2
2004,Engineering,Nuclear Engineering,45,34,11
2018,Engineering,"Nuclear, Plasma, Radiolgc Engr ",47,45,2
2018,Engineering,"Nuclear, Plasma, Radiolgc Engr ",44,35,9
2018,Engineering,"Nuclear, Plasma, Radiolgc Engr ",22,17,5
2018,Engineering,"Nuclear, Plasma, Radiolgc Engr ",10,8,2
2018,Engineering,"Nuclear, Plasma, Radiolgc Engr ",33,29,4
2018,Engineering,"Nuclear, Plasma, Radiolgc Engr ",2,2,0
2018,Engineering,"Nuclear, Plasma, Radiolgc Engr ",55,51,4
2018,Engineering,"Nuclear, Plasma, Radiolgc Engr ",5,3,2
2017,Engineering,"Nuclear, Plasma, Radiolgc Engr ",76,66,10
2017,Engineering,"Nuclear, Plasma, Radiolgc Engr ",36,30,6
2017,Engineering,"Nuclear, Plasma, Radiolgc Engr ",20,16,4
2017,Engineering,"Nuclear, Plasma, Radiolgc Engr ",9,5,4
2017,Engineering,"Nuclear, Plasma, Radiolgc Engr ",24,22,2
2017,Engineering,"Nuclear, Plasma, Radiolgc Engr ",1,0,1
2017,Engineering,"Nuclear, Plasma, Radiolgc Engr ",1,1,0
2017,Engineering,"Nuclear, Plasma, Radiolgc Engr ",65,60,5
2017,Engineering,"Nuclear, Plasma, Radiolgc Engr ",2,1,1
2016,Engineering,"Nuclear, Plasma, Radiolgc Engr ",81,66,15
2016,Engineering,"Nuclear, Plasma, Radiolgc Engr ",40,34,6
2016,Engineering,"Nuclear, Plasma, Radiolgc Engr ",15,14,1
2016,Engineering,"Nuclear, Plasma, Radiolgc Engr ",6,5,1
2016,Engineering,"Nuclear, Plasma, Radiolgc Engr ",17,15,2
2016,Engineering,"Nuclear, Plasma, Radiolgc Engr ",72,66,6
2015,Engineering,"Nuclear, Plasma, Radiolgc Engr ",9,7,2
2015,Engineering,"Nuclear, Plasma, Radiolgc Engr ",2,1,1
2015,Engineering,"Nuclear, Plasma, Radiolgc Engr ",18,18,0
2015,Engineering,"Nuclear, Plasma, Radiolgc Engr ",15,14,1
2015,Engineering,"Nuclear, Plasma, Radiolgc Engr ",49,41,8
2015,Engineering,"Nuclear, Plasma, Radiolgc Engr ",82,70,12
2015,Engineering,"Nuclear, Plasma, Radiolgc Engr ",58,53,5
2014,Engineering,"Nuclear, Plasma, Radiolgc Engr ",9,6,3
2014,Engineering,"Nuclear, Plasma, Radiolgc Engr ",19,18,1
2014,Engineering,"Nuclear, Plasma, Radiolgc Engr ",40,35,5
2014,Engineering,"Nuclear, Plasma, Radiolgc Engr ",20,18,2
2014,Engineering,"Nuclear, Plasma, Radiolgc Engr ",79,63,16
2014,Engineering,"Nuclear, Plasma, Radiolgc Engr ",48,45,3
2013,Engineering,"Nuclear, Plasma, Radiolgc Engr ",26,23,3
2013,Engineering,"Nuclear, Plasma, Radiolgc Engr ",8,7,1
2013,Engineering,"Nuclear, Plasma, Radiolgc Engr ",19,18,1
2013,Engineering,"Nuclear, Plasma, Radiolgc Engr ",41,38,3
2013,Engineering,"Nuclear, Plasma, Radiolgc Engr ",50,46,4
2013,Engineering,"Nuclear, Plasma, Radiolgc Engr ",81,64,17
2012,Engineering,"Nuclear, Plasma, Radiolgc Engr ",19,17,2
2012,Engineering,"Nuclear, Plasma, Radiolgc Engr ",7,5,2
2012,Engineering,"Nuclear, Plasma, Radiolgc Engr ",18,18,0
2012,Engineering,"Nuclear, Plasma, Radiolgc Engr ",37,31,6
2012,Engineering,"Nuclear, Plasma, Radiolgc Engr ",55,52,3
2012,Engineering,"Nuclear, Plasma, Radiolgc Engr ",95,80,15
2011,Engineering,"Nuclear, Plasma, Radiolgc Engr ",50,44,6
2011,Engineering,"Nuclear, Plasma, Radiolgc Engr ",6,4,2
2011,Engineering,"Nuclear, Plasma, Radiolgc Engr ",18,18,0
2011,Engineering,"Nuclear, Plasma, Radiolgc Engr ",28,21,7
2011,Engineering,"Nuclear, Plasma, Radiolgc Engr ",15,13,2
2011,Engineering,"Nuclear, Plasma, Radiolgc Engr ",92,84,8
2010,Engineering,"Nuclear, Plasma, Radiolgc Engr ",76,65,11
2010,Engineering,"Nuclear, Plasma, Radiolgc Engr ",3,2,1
2010,Engineering,"Nuclear, Plasma, Radiolgc Engr ",2,1,1
2010,Engineering,"Nuclear, Plasma, Radiolgc Engr ",1,1,0
2010,Engineering,"Nuclear, Plasma, Radiolgc Engr ",13,12,1
2010,Engineering,"Nuclear, Plasma, Radiolgc Engr ",1,1,0
2010,Engineering,"Nuclear, Plasma, Radiolgc Engr ",22,17,5
2009,Engineering,"Nuclear, Plasma, Radiolgc Engr ",3,2,1
2009,Engineering,"Nuclear, Plasma, Radiolgc Engr ",3,2,1
2009,Engineering,"Nuclear, Plasma, Radiolgc Engr ",1,1,0
2009,Engineering,"Nuclear, Plasma, Radiolgc Engr ",10,7,3
2009,Engineering,"Nuclear, Plasma, Radiolgc Engr ",15,15,0
2009,Engineering,"Nuclear, Plasma, Radiolgc Engr ",70,56,14
1980,ACES,Nutritional Sciences,30,11,19
1981,ACES,Nutritional Sciences,43,14,29
1982,ACES,Nutritional Sciences,40,14,26
1983,ACES,Nutritional Sciences,41,12,29
1984,ACES,Nutritional Sciences,37,11,26
1985,ACES,Nutritional Sciences,38,13,25
1986,ACES,Nutritional Sciences,39,15,24
1987,ACES,Nutritional Sciences,44,17,27
1988,ACES,Nutritional Sciences,41,9,32
1989,ACES,Nutritional Sciences,38,10,28
1990,ACES,Nutritional Sciences,38,14,24
1991,ACES,Nutritional Sciences,41,17,24
1992,ACES,Nutritional Sciences,34,14,20
1993,ACES,Nutritional Sciences,43,16,27
1994,ACES,Nutritional Sciences,53,19,34
1995,ACES,Nutritional Sciences,43,15,28
1996,ACES,Nutritional Sciences,47,18,29
1997,ACES,Nutritional Sciences,37,13,24
1998,ACES,Nutritional Sciences,44,14,30
1999,ACES,Nutritional Sciences,39,13,26
2000,ACES,Nutritional Sciences,35,13,22
2001,ACES,Nutritional Sciences,34,10,24
2002,ACES,Nutritional Sciences,35,8,27
2003,ACES,Nutritional Sciences,44,9,35
2018,ACES,Nutritional Sciences,15,5,10
2018,ACES,Nutritional Sciences,26,5,21
2017,ACES,Nutritional Sciences,20,3,17
2017,ACES,Nutritional Sciences,29,9,20
2016,ACES,Nutritional Sciences,22,2,20
2016,ACES,Nutritional Sciences,30,9,21
2015,ACES,Nutritional Sciences,18,3,15
2015,ACES,Nutritional Sciences,27,10,17
2014,ACES,Nutritional Sciences,13,2,11
2014,ACES,Nutritional Sciences,30,10,20
2013,ACES,Nutritional Sciences,11,2,9
2013,ACES,Nutritional Sciences,31,12,19
2012,ACES,Nutritional Sciences,22,5,17
2012,ACES,Nutritional Sciences,16,6,10
2011,ACES,Nutritional Sciences,27,6,21
2011,ACES,Nutritional Sciences,22,8,14
2010,ACES,Nutritional Sciences,25,7,18
2010,ACES,Nutritional Sciences,32,9,23
2009,ACES,Nutritional Sciences,22,5,17
2009,ACES,Nutritional Sciences,36,9,27
2008,ACES,Nutritional Sciences,1,0,1
2008,ACES,Nutritional Sciences,24,4,20
2008,ACES,Nutritional Sciences,36,10,26
2007,ACES,Nutritional Sciences,27,4,23
2007,ACES,Nutritional Sciences,33,12,21
2006,ACES,Nutritional Sciences,26,4,22
2006,ACES,Nutritional Sciences,35,11,24
2005,ACES,Nutritional Sciences,25,2,23
2005,ACES,Nutritional Sciences,28,8,20
2004,ACES,Nutritional Sciences,22,2,20
2004,ACES,Nutritional Sciences,33,9,24
2018,Fine and Applied Arts,Open Studies,5,2,3
2017,Fine and Applied Arts,Open Studies,6,2,4
2016,Fine and Applied Arts,Open Studies,3,0,3
2015,Fine and Applied Arts,Open Studies,3,0,3
2014,Fine and Applied Arts,Open Studies,3,0,3
2013,Fine and Applied Arts,Open Studies,5,0,5
2012,Fine and Applied Arts,Open Studies,4,1,3
2011,Fine and Applied Arts,Open Studies,6,3,3
2010,Fine and Applied Arts,Open Studies,8,3,5
2009,Fine and Applied Arts,Open Studies,12,7,5
2008,Fine and Applied Arts,Open Studies,12,8,4
2007,Fine and Applied Arts,Open Studies,9,5,4
2006,Fine and Applied Arts,Open Studies,22,18,4
2005,Fine and Applied Arts,Open Studies,20,15,5
2004,Fine and Applied Arts,Open Studies,10,8,2
2018,Business,Operations Management,6,3,3
2018,Business,Operations Management,5,3,2
2017,Business,Operations Management,1,1,0
1980,ACES,ORN HORT,118,51,67
1980,ACES,ORN HORT,4,2,2
1981,ACES,ORN HORT,104,60,44
1982,ACES,ORN HORT,92,42,50
1983,ACES,ORN HORT,81,32,49
1984,ACES,ORN HORT,64,30,34
1985,ACES,ORN HORT,61,31,30
1986,ACES,ORN HORT,63,30,33
1987,ACES,ORN HORT,74,35,39
1988,ACES,ORN HORT,71,34,37
1989,ACES,ORN HORT,54,27,27
1990,ACES,ORN HORT,66,32,34
1991,ACES,ORN HORT,78,44,34
1992,ACES,ORN HORT,89,49,40
1993,ACES,ORN HORT,87,44,43
1994,ACES,ORN HORT,86,49,37
1995,ACES,ORN HORT,84,49,35
1996,ACES,ORN HORT,87,46,41
1997,ACES,ORN HORT,64,27,37
1998,ACES,ORN HORT,39,17,22
1999,ACES,ORN HORT,15,8,7
1980,Applied Health Sciences,OUTDR REC,41,17,24
1981,Applied Health Sciences,OUTDR REC,37,15,22
1982,Applied Health Sciences,OUTDR REC,49,20,29
1983,Applied Health Sciences,OUTDR REC,41,17,24
1984,Applied Health Sciences,OUTDR REC,41,24,17
1985,Applied Health Sciences,OUTDR REC,27,16,11
1986,Applied Health Sciences,OUTDR REC,21,11,10
1987,Applied Health Sciences,OUTDR REC,26,15,11
1988,Applied Health Sciences,OUTDR REC,19,13,6
1989,Applied Health Sciences,OUTDR REC,23,15,8
1990,Applied Health Sciences,OUTDR REC,8,6,2
1991,Applied Health Sciences,OUTDR REC,3,2,1
2018,Fine and Applied Arts,Painting,36,4,32
2017,Fine and Applied Arts,Painting,31,7,24
2016,Fine and Applied Arts,Painting,30,6,24
2015,Fine and Applied Arts,Painting,20,4,16
2014,Fine and Applied Arts,Painting,21,4,17
2013,Fine and Applied Arts,Painting,25,9,16
2012,Fine and Applied Arts,Painting,38,12,26
2011,Fine and Applied Arts,Painting,43,11,32
2010,Fine and Applied Arts,Painting,35,9,26
2009,Fine and Applied Arts,Painting,31,9,22
2008,Fine and Applied Arts,Painting,35,11,24
2007,Fine and Applied Arts,Painting,41,13,28
2006,Fine and Applied Arts,Painting,46,17,29
2005,Fine and Applied Arts,Painting,48,16,32
2004,Fine and Applied Arts,Painting,48,20,28
1996,Applied Health Sciences,PARK & NR MGMT,3,1,2
1997,Applied Health Sciences,PARK & NR MGMT,5,2,3
1998,Applied Health Sciences,PARK & NR MGMT,12,9,3
1999,Applied Health Sciences,PARK & NR MGMT,14,12,2
2000,Applied Health Sciences,PARK & NR MGMT,10,9,1
2001,Applied Health Sciences,PARK & NR MGMT,4,3,1
2002,Applied Health Sciences,PARK & NR MGMT,5,2,3
2003,Applied Health Sciences,PARK & NR MGMT,8,6,2
1980,Fine and Applied Arts,PERFORM ST,24,18,6
1981,Fine and Applied Arts,PERFORM ST,21,11,10
1982,Fine and Applied Arts,PERFORM ST,26,17,9
1983,Fine and Applied Arts,PERFORM ST,23,13,10
1984,Fine and Applied Arts,PERFORM ST,18,11,7
1985,Fine and Applied Arts,PERFORM ST,16,6,10
1986,Fine and Applied Arts,PERFORM ST,11,5,6
1987,Fine and Applied Arts,PERFORM ST,12,5,7
1988,Fine and Applied Arts,PERFORM ST,9,4,5
1989,Fine and Applied Arts,PERFORM ST,12,5,7
1990,Fine and Applied Arts,PERFORM ST,9,6,3
1991,Fine and Applied Arts,PERFORM ST,11,4,7
1992,Fine and Applied Arts,PERFORM ST,11,3,8
1993,Fine and Applied Arts,PERFORM ST,12,6,6
1994,Fine and Applied Arts,PERFORM ST,10,6,4
1995,Fine and Applied Arts,PERFORM ST,9,5,4
1996,Fine and Applied Arts,PERFORM ST,12,5,7
1997,Fine and Applied Arts,PERFORM ST,24,12,12
1998,Fine and Applied Arts,PERFORM ST,35,12,23
1999,Fine and Applied Arts,PERFORM ST,35,10,25
2000,Fine and Applied Arts,PERFORM ST,42,14,28
2001,Fine and Applied Arts,PERFORM ST,36,10,26
2002,Fine and Applied Arts,PERFORM ST,30,11,19
2003,Fine and Applied Arts,PERFORM ST,25,8,17
1985,Applied Health Sciences,PERSN AREA,2,1,1
1987,Applied Health Sciences,PERSN AREA,2,1,1
1989,Applied Health Sciences,PERSN AREA,2,1,1
1992,Applied Health Sciences,PERSN AREA,2,1,1
1993,Applied Health Sciences,PERSN AREA,2,1,1
2018,LAS,Philosophy,82,61,21
2018,LAS,Philosophy,5,3,2
2018,LAS,Philosophy,24,18,6
2017,LAS,Philosophy,60,43,17
2017,LAS,Philosophy,8,4,4
2017,LAS,Philosophy,22,16,6
2016,LAS,Philosophy,66,53,13
2016,LAS,Philosophy,4,1,3
2016,LAS,Philosophy,21,14,7
2015,LAS,Philosophy,4,2,2
2015,LAS,Philosophy,57,40,17
2015,LAS,Philosophy,18,16,2
2014,LAS,Philosophy,3,2,1
2014,LAS,Philosophy,57,42,15
2014,LAS,Philosophy,19,16,3
2013,LAS,Philosophy,4,3,1
2013,LAS,Philosophy,22,19,3
2013,LAS,Philosophy,64,43,21
2012,LAS,Philosophy,4,3,1
2012,LAS,Philosophy,34,29,5
2012,LAS,Philosophy,82,55,26
2011,LAS,Philosophy,2,2,0
2011,LAS,Philosophy,33,29,4
2011,LAS,Philosophy,94,68,26
2010,LAS,Philosophy,3,2,1
2010,LAS,Philosophy,35,31,4
2010,LAS,Philosophy,87,70,17
2009,LAS,Philosophy,3,3,0
2009,LAS,Philosophy,93,73,20
2009,LAS,Philosophy,33,31,2
2008,LAS,Philosophy,1,1,0
2008,LAS,Philosophy,4,3,1
2008,LAS,Philosophy,86,71,15
2008,LAS,Philosophy,35,28,7
2007,LAS,Philosophy,1,0,1
2007,LAS,Philosophy,1,1,0
2007,LAS,Philosophy,2,1,1
2007,LAS,Philosophy,83,65,18
2007,LAS,Philosophy,37,30,7
2006,LAS,Philosophy,2,1,1
2006,LAS,Philosophy,1,0,1
2006,LAS,Philosophy,2,1,1
2006,LAS,Philosophy,89,70,19
2006,LAS,Philosophy,38,32,6
2005,LAS,Philosophy,2,1,1
2005,LAS,Philosophy,2,1,1
2005,LAS,Philosophy,95,73,22
2005,LAS,Philosophy,38,30,8
2004,LAS,Philosophy,92,72,20
2004,LAS,Philosophy,3,3,0
2004,LAS,Philosophy,42,31,11
1980,LAS,Philosophy,33,28,5
1981,LAS,Philosophy,29,24,5
1982,LAS,Philosophy,33,29,4
1983,LAS,Philosophy,38,32,6
1984,LAS,Philosophy,36,33,3
1985,LAS,Philosophy,42,35,7
1986,LAS,Philosophy,40,31,9
1987,LAS,Philosophy,42,33,9
1988,LAS,Philosophy,39,31,8
1989,LAS,Philosophy,37,27,10
1990,LAS,Philosophy,38,28,10
1991,LAS,Philosophy,38,30,8
1992,LAS,Philosophy,45,34,11
1993,LAS,Philosophy,46,37,9
1994,LAS,Philosophy,54,44,10
1995,LAS,Philosophy,44,34,10
1996,LAS,Philosophy,39,30,9
1997,LAS,Philosophy,41,32,9
1998,LAS,Philosophy,44,35,9
1999,LAS,Philosophy,41,31,10
2000,LAS,Philosophy,42,36,6
2001,LAS,Philosophy,37,32,5
2002,LAS,Philosophy,37,31,6
2003,LAS,Philosophy,39,33,6
2018,Fine and Applied Arts,Photography,32,8,24
2017,Fine and Applied Arts,Photography,30,7,23
2016,Fine and Applied Arts,Photography,21,3,18
2015,Fine and Applied Arts,Photography,9,1,8
2014,Fine and Applied Arts,Photography,16,3,13
2013,Fine and Applied Arts,Photography,28,9,19
2012,Fine and Applied Arts,Photography,32,12,20
2011,Fine and Applied Arts,Photography,42,11,31
2010,Fine and Applied Arts,Photography,36,9,27
2009,Fine and Applied Arts,Photography,33,8,25
2008,Fine and Applied Arts,Photography,29,13,16
2007,Fine and Applied Arts,Photography,35,15,20
2006,Fine and Applied Arts,Photography,32,13,19
2005,Fine and Applied Arts,Photography,33,11,22
2004,Fine and Applied Arts,Photography,21,5,16
2018,Engineering,Physics,2,1,1
2018,Engineering,Physics,283,206,77
2018,Engineering,Physics,5,4,1
2017,Engineering,Physics,1,0,1
2017,Engineering,Physics,292,220,72
2017,Engineering,Physics,4,3,1
2016,Engineering,Physics,3,3,0
2016,Engineering,Physics,280,214,66
2016,Engineering,Physics,3,2,1
2015,Engineering,Physics,3,3,0
2015,Engineering,Physics,258,200,58
2014,Engineering,Physics,3,2,1
2014,Engineering,Physics,254,205,49
2013,Engineering,Physics,1,0,1
2013,Engineering,Physics,254,212,42
2012,Engineering,Physics,2,1,1
2012,Engineering,Physics,252,212,40
2011,Engineering,Physics,1,1,0
2011,Engineering,Physics,264,226,38
2010,Engineering,Physics,1,1,0
2010,Engineering,Physics,259,225,34
2009,Engineering,Physics,1,1,0
2009,Engineering,Physics,274,237,37
2008,Engineering,Physics,3,3,0
2008,Engineering,Physics,299,259,40
2007,Engineering,Physics,1,1,0
2007,Engineering,Physics,2,2,0
2007,Engineering,Physics,285,245,40
2006,Engineering,Physics,3,3,0
2006,Engineering,Physics,4,4,0
2006,Engineering,Physics,291,251,40
2005,Engineering,Physics,1,1,0
2005,Engineering,Physics,2,2,0
2005,Engineering,Physics,293,255,38
2004,Engineering,Physics,2,2,0
2004,Engineering,Physics,4,3,1
2004,Engineering,Physics,293,254,39
2018,LAS,Physics,202,156,46
2018,LAS,Physics,55,48,7
2018,LAS,Physics,14,12,2
2018,LAS,Physics,3,2,1
2018,LAS,Physics,1,1,0
2017,LAS,Physics,259,210,49
2017,LAS,Physics,69,60,9
2017,LAS,Physics,15,14,1
2017,LAS,Physics,8,7,1
2016,LAS,Physics,284,238,46
2016,LAS,Physics,94,78,16
2016,LAS,Physics,15,13,2
2016,LAS,Physics,2,1,1
2015,LAS,Physics,2,1,1
2015,LAS,Physics,18,17,1
2015,LAS,Physics,125,106,19
2015,LAS,Physics,241,208,33
2014,LAS,Physics,2,2,0
2014,LAS,Physics,15,14,1
2014,LAS,Physics,186,168,18
2014,LAS,Physics,199,169,29
2013,LAS,Physics,7,7,0
2013,LAS,Physics,8,6,2
2013,LAS,Physics,133,121,12
2013,LAS,Physics,181,158,23
2012,LAS,Physics,2,2,0
2012,LAS,Physics,8,7,1
2012,LAS,Physics,127,110,17
2012,LAS,Physics,151,137,14
2011,LAS,Physics,91,76,15
2011,LAS,Physics,1,1,0
2011,LAS,Physics,8,7,1
2011,LAS,Physics,142,125,17
2010,LAS,Physics,74,59,14
2010,LAS,Physics,5,5,0
2010,LAS,Physics,8,7,1
2010,LAS,Physics,102,90,12
2009,LAS,Physics,7,6,1
2009,LAS,Physics,6,6,0
2009,LAS,Physics,71,63,8
2009,LAS,Physics,84,74,10
2008,LAS,Physics,1,1,0
2008,LAS,Physics,8,5,3
2008,LAS,Physics,1,1,0
2008,LAS,Physics,72,63,9
2008,LAS,Physics,65,56,8
2007,LAS,Physics,4,2,2
2007,LAS,Physics,2,1,1
2007,LAS,Physics,83,75,8
2007,LAS,Physics,75,61,13
2006,LAS,Physics,5,3,2
2006,LAS,Physics,78,64,13
2006,LAS,Physics,94,74,20
2005,LAS,Physics,5,2,3
2005,LAS,Physics,81,64,17
2005,LAS,Physics,101,79,22
2004,LAS,Physics,84,65,19
2004,LAS,Physics,104,79,25
2004,LAS,Physics,2,1,1
2018,LAS,Plant Biology,3,1,2
2018,LAS,Plant Biology,29,10,19
2018,LAS,Plant Biology,1,1,0
2017,LAS,Plant Biology,3,1,2
2017,LAS,Plant Biology,29,11,18
2016,LAS,Plant Biology,3,1,2
2016,LAS,Plant Biology,34,14,20
2015,LAS,Plant Biology,5,1,4
2015,LAS,Plant Biology,31,13,18
2014,LAS,Plant Biology,5,4,1
2014,LAS,Plant Biology,9,4,5
2014,LAS,Plant Biology,28,15,13
2013,LAS,Plant Biology,7,4,3
2013,LAS,Plant Biology,5,4,1
2013,LAS,Plant Biology,32,16,16
2012,LAS,Plant Biology,7,4,3
2012,LAS,Plant Biology,3,2,1
2012,LAS,Plant Biology,33,15,18
2011,LAS,Plant Biology,5,2,3
2011,LAS,Plant Biology,3,2,1
2011,LAS,Plant Biology,33,12,21
2010,LAS,Plant Biology,8,4,4
2010,LAS,Plant Biology,32,13,19
2009,LAS,Plant Biology,10,5,5
2009,LAS,Plant Biology,30,12,18
2008,LAS,Plant Biology,11,3,8
2008,LAS,Plant Biology,19,9,10
2007,LAS,Plant Biology,11,5,6
2007,LAS,Plant Biology,14,8,6
2006,LAS,Plant Biology,1,1,0
2006,LAS,Plant Biology,6,1,5
2006,LAS,Plant Biology,16,9,7
2005,LAS,Plant Biology,6,2,4
2005,LAS,Plant Biology,14,8,6
2004,LAS,Plant Biology,6,2,4
2004,LAS,Plant Biology,13,7,6
1980,LAS,Plant Biology,31,18,13
1981,LAS,Plant Biology,26,15,11
1982,LAS,Plant Biology,30,15,15
1983,LAS,Plant Biology,27,16,11
1984,LAS,Plant Biology,27,14,13
1985,LAS,Plant Biology,31,15,16
1986,LAS,Plant Biology,28,11,17
1987,LAS,Plant Biology,38,13,25
1988,LAS,Plant Biology,34,10,24
1989,LAS,Plant Biology,32,7,25
1990,LAS,Plant Biology,29,7,22
1991,LAS,Plant Biology,27,11,16
1992,LAS,Plant Biology,23,9,14
1993,LAS,Plant Biology,30,13,17
1994,LAS,Plant Biology,37,15,22
1995,LAS,Plant Biology,41,18,23
1996,LAS,Plant Biology,40,19,21
1997,LAS,Plant Biology,37,16,21
1998,LAS,Plant Biology,35,16,19
1999,LAS,Plant Biology,26,12,14
2000,LAS,Plant Biology,26,14,12
2001,LAS,Plant Biology,27,14,13
2002,LAS,Plant Biology,28,11,17
2003,LAS,Plant Biology,22,11,11
2015,LAS,Plant Biotechnology,3,2,1
2014,LAS,Plant Biotechnology,3,2,1
1980,ACES,PLANT PATH,34,28,6
1981,ACES,PLANT PATH,40,30,10
1982,ACES,PLANT PATH,41,29,12
1983,ACES,PLANT PATH,39,28,11
1984,ACES,PLANT PATH,36,25,11
1985,ACES,PLANT PATH,38,27,11
1986,ACES,PLANT PATH,37,27,10
1987,ACES,PLANT PATH,32,23,9
1988,ACES,PLANT PATH,30,20,10
1989,ACES,PLANT PATH,28,20,8
1990,ACES,PLANT PATH,28,19,9
1991,ACES,PLANT PATH,29,16,13
1992,ACES,PLANT PATH,33,22,11
1993,ACES,PLANT PATH,32,21,11
1994,ACES,PLANT PATH,32,22,10
1995,ACES,PLANT PATH,23,17,6
1996,ACES,PLANT PATH,23,18,5
1997,ACES,PLANT PATH,19,14,5
1998,ACES,PLANT PATH,12,10,2
1999,ACES,PLANT PATH,11,9,2
2000,ACES,PLANT PATH,5,4,1
2011,ACES,Plant Pathology,1,0,1
2018,LAS,Political Science,621,340,280
2018,LAS,Political Science,87,47,40
2018,LAS,Political Science,12,6,6
2018,LAS,Political Science,48,29,19
2017,LAS,Political Science,568,334,234
2017,LAS,Political Science,80,38,42
2017,LAS,Political Science,48,26,22
2016,LAS,Political Science,453,259,194
2016,LAS,Political Science,112,57,55
2016,LAS,Political Science,1,0,1
2016,LAS,Political Science,49,26,23
2015,LAS,Political Science,1,0,1
2015,LAS,Political Science,114,60,54
2015,LAS,Political Science,45,27,18
2015,LAS,Political Science,468,283,185
2014,LAS,Political Science,129,79,50
2014,LAS,Political Science,48,28,20
2014,LAS,Political Science,511,311,200
2013,LAS,Political Science,2,1,1
2013,LAS,Political Science,7,3,4
2013,LAS,Political Science,54,35,19
2013,LAS,Political Science,101,62,39
2013,LAS,Political Science,552,359,193
2012,LAS,Political Science,1,1,0
2012,LAS,Political Science,1,1,0
2012,LAS,Political Science,10,3,7
2012,LAS,Political Science,49,30,19
2012,LAS,Political Science,72,39,33
2012,LAS,Political Science,616,405,210
2011,LAS,Political Science,3,3,0
2011,LAS,Political Science,1,0,1
2011,LAS,Political Science,9,3,6
2011,LAS,Political Science,51,31,20
2011,LAS,Political Science,74,37,37
2011,LAS,Political Science,688,430,258
2010,LAS,Political Science,1,1,0
2010,LAS,Political Science,9,5,4
2010,LAS,Political Science,68,35,33
2010,LAS,Political Science,63,34,29
2010,LAS,Political Science,772,495,277
2009,LAS,Political Science,8,2,6
2009,LAS,Political Science,1,0,1
2009,LAS,Political Science,65,29,36
2009,LAS,Political Science,63,35,28
2009,LAS,Political Science,880,560,320
2008,LAS,Political Science,10,4,6
2008,LAS,Political Science,1,1,0
2008,LAS,Political Science,19,8,11
2008,LAS,Political Science,966,584,382
2008,LAS,Political Science,66,41,25
2007,LAS,Political Science,16,10,6
2007,LAS,Political Science,10,4,6
2007,LAS,Political Science,57,31,26
2007,LAS,Political Science,1047,606,439
2006,LAS,Political Science,4,1,3
2006,LAS,Political Science,19,10,9
2006,LAS,Political Science,56,32,24
2006,LAS,Political Science,1035,589,445
2005,LAS,Political Science,2,1,1
2005,LAS,Political Science,3,0,3
2005,LAS,Political Science,20,10,10
2005,LAS,Political Science,46,24,22
2005,LAS,Political Science,993,607,383
2004,LAS,Political Science,889,529,359
2004,LAS,Political Science,11,4,7
2004,LAS,Political Science,39,25,14
1980,LAS,Political Science,46,29,17
1981,LAS,Political Science,42,28,14
1982,LAS,Political Science,40,30,10
1983,LAS,Political Science,31,23,8
1984,LAS,Political Science,43,32,11
1985,LAS,Political Science,60,41,19
1986,LAS,Political Science,49,35,14
1987,LAS,Political Science,49,38,11
1988,LAS,Political Science,66,46,20
1989,LAS,Political Science,61,41,20
1990,LAS,Political Science,59,41,18
1991,LAS,Political Science,77,48,29
1992,LAS,Political Science,66,46,20
1993,LAS,Political Science,69,51,18
1994,LAS,Political Science,62,44,18
1995,LAS,Political Science,62,45,17
1996,LAS,Political Science,47,32,15
1997,LAS,Political Science,40,30,10
1998,LAS,Political Science,42,32,10
1999,LAS,Political Science,42,28,14
2000,LAS,Political Science,34,24,10
2001,LAS,Political Science,36,23,13
2002,LAS,Political Science,40,24,16
2003,LAS,Political Science,44,28,16
2018,LAS,Portuguese,1,0,1
2015,LAS,Portuguese,1,0,1
2014,LAS,Portuguese,3,1,2
2013,LAS,Portuguese,1,1,0
2013,LAS,Portuguese,2,0,2
2012,LAS,Portuguese,1,1,0
2012,LAS,Portuguese,2,0,2
2012,LAS,Portuguese,1,0,1
2011,LAS,Portuguese,1,1,0
2011,LAS,Portuguese,1,0,1
2011,LAS,Portuguese,2,1,1
2010,LAS,Portuguese,2,1,1
2009,LAS,Portuguese,2,1,1
2008,LAS,Portuguese,2,1,1
2007,LAS,Portuguese,2,1,1
2007,LAS,Portuguese,1,0,1
2007,LAS,Portuguese,3,1,2
2006,LAS,Portuguese,2,1,1
2005,LAS,Portuguese,1,1,0
2005,LAS,Portuguese,1,0,1
2004,LAS,Portuguese,1,1,0
2004,LAS,Portuguese,1,0,1
1992,LAS,Portuguese,6,1,5
1993,LAS,Portuguese,4,1,3
1994,LAS,Portuguese,6,2,4
1995,LAS,Portuguese,5,2,3
1996,LAS,Portuguese,5,2,3
1998,LAS,Portuguese,3,1,2
1999,LAS,Portuguese,3,1,2
2000,LAS,Portuguese,3,1,2
2001,LAS,Portuguese,2,1,1
2002,LAS,Portuguese,3,1,2
2003,LAS,Portuguese,3,1,2
1985,Aviation,PP/AS,53,50,3
1986,Aviation,PP/AS,107,95,12
1987,Aviation,PP/AS,119,102,17
1988,Aviation,PP/AS,109,93,16
1989,Aviation,PP/AS,97,84,13
1990,Aviation,PP/AS,108,98,10
1991,Aviation,PP/AS,102,94,8
1992,Aviation,PP/AS,84,76,8
1993,Aviation,PP/AS,83,73,10
1994,Aviation,PP/AS,77,72,5
1995,Aviation,PP/AS,36,34,2
1996,Aviation,PP/AS,21,20,1
2016,Education,Pre-Early Chld/Elem Ed/Spec Ed,13,3,10
2015,Education,Pre-Early Chld/Elem Ed/Spec Ed,22,3,19
2014,Education,Pre-Early Chld/Elem Ed/Spec Ed,241,18,223
2013,Education,Pre-Early Chld/Elem Ed/Spec Ed,271,29,242
2012,Education,Pre-Early Chld/Elem Ed/Spec Ed,260,15,245
2011,Education,Pre-Early Chld/Elem Ed/Spec Ed,270,18,252
2010,Education,Pre-Early Chld/Elem Ed/Spec Ed,287,21,266
2009,Education,Pre-Early Chld/Elem Ed/Spec Ed,328,21,306
2008,Education,Pre-Early Chld/Elem Ed/Spec Ed,288,24,264
2007,Education,Pre-Early Chld/Elem Ed/Spec Ed,272,22,250
2006,Education,Pre-Early Chld/Elem Ed/Spec Ed,188,22,166
2018,DGS,Pre-Engineering,488,394,94
2017,DGS,Pre-Engineering,241,210,31
1980,LAS,PRE-JOURN,57,24,33
1981,LAS,PRE-JOURN,82,27,55
1982,LAS,PRE-JOURN,150,47,103
1983,LAS,PRE-JOURN,227,77,150
1984,LAS,PRE-JOURN,334,86,248
1985,LAS,PRE-JOURN,445,118,327
1986,LAS,PRE-JOURN,540,151,389
1987,LAS,PRE-JOURN,605,191,414
1988,LAS,PRE-JOURN,554,190,364
1989,LAS,PRE-JOURN,539,183,356
1990,LAS,PRE-JOURN,545,194,351
1991,LAS,PRE-JOURN,508,183,325
1992,LAS,PRE-JOURN,435,167,268
1993,LAS,PRE-JOURN,343,129,214
1994,LAS,PRE-JOURN,276,113,163
1995,LAS,PRE-JOURN,316,112,204
1996,LAS,PRE-JOURN,363,131,232
1997,LAS,PRE-JOURN,347,123,224
1998,LAS,PRE-JOURN,367,100,267
1999,LAS,PRE-JOURN,424,114,310
2000,LAS,PRE-JOURN,587,185,402
2001,LAS,PRE-JOURN,512,138,374
2002,LAS,PRE-JOURN,544,151,393
2003,LAS,PRE-JOURN,593,171,422
1980,LAS,PRE-MED,28,18,10
1981,LAS,PRE-MED,22,13,9
1982,LAS,PRE-MED,69,31,38
1983,LAS,PRE-MED,137,71,66
1984,LAS,PRE-MED,275,129,146
1985,LAS,PRE-MED,275,118,157
1986,LAS,PRE-MED,210,101,109
1987,LAS,PRE-MED,193,106,87
1988,LAS,PRE-MED,186,95,91
1989,LAS,PRE-MED,169,90,79
1990,LAS,PRE-MED,164,90,74
1991,LAS,PRE-MED,172,91,81
1992,LAS,PRE-MED,213,98,115
1993,LAS,PRE-MED,251,127,124
1994,LAS,PRE-MED,299,144,155
1995,LAS,PRE-MED,293,138,155
1996,LAS,PRE-MED,264,122,142
1997,LAS,PRE-MED,249,114,135
1998,LAS,PRE-MED,255,101,154
1999,LAS,PRE-MED,258,110,148
2000,LAS,PRE-MED,241,100,141
2001,LAS,PRE-MED,240,95,145
2002,LAS,PRE-MED,213,91,122
2003,LAS,PRE-MED,303,129,174
1980,Aviation,Professional Pilot,14,10,4
1981,Aviation,Professional Pilot,12,9,3
1982,Aviation,Professional Pilot,9,7,2
1983,Aviation,Professional Pilot,15,14,1
1984,Aviation,Professional Pilot,35,30,5
1985,Aviation,Professional Pilot,71,59,12
1986,Aviation,Professional Pilot,67,58,9
1987,Aviation,Professional Pilot,60,52,8
1988,Aviation,Professional Pilot,59,52,7
1989,Aviation,Professional Pilot,71,57,14
1990,Aviation,Professional Pilot,74,59,15
1991,Aviation,Professional Pilot,75,61,14
1992,Aviation,Professional Pilot,99,78,21
1993,Aviation,Professional Pilot,100,73,27
1994,Aviation,Professional Pilot,111,81,30
1995,Aviation,Professional Pilot,151,113,38
1996,Aviation,Professional Pilot,150,119,31
1997,Aviation,Professional Pilot,139,113,26
1998,Aviation,Professional Pilot,151,124,27
1999,Aviation,Professional Pilot,170,143,27
2000,Aviation,Professional Pilot,121,105,16
2001,Aviation,Professional Pilot,77,71,6
2002,Aviation,Professional Pilot,66,59,7
2003,Aviation,Professional Pilot,73,65,8
2012,Aviation,Professional Pilot,9,8,1
2011,Aviation,Professional Pilot,26,25,1
2010,Aviation,Professional Pilot,48,45,3
2009,Aviation,Professional Pilot,36,33,3
2008,Aviation,Professional Pilot,56,51,5
2007,Aviation,Professional Pilot,1,1,0
2007,Aviation,Professional Pilot,64,57,7
2006,Aviation,Professional Pilot,1,1,0
2006,Aviation,Professional Pilot,91,84,7
2005,Aviation,Professional Pilot,2,1,1
2005,Aviation,Professional Pilot,1,0,1
2005,Aviation,Professional Pilot,69,64,5
2004,Aviation,Professional Pilot,65,57,8
1980,Applied Health Sciences,PROG MANAG,97,32,65
1981,Applied Health Sciences,PROG MANAG,102,39,63
1982,Applied Health Sciences,PROG MANAG,104,39,65
1983,Applied Health Sciences,PROG MANAG,107,43,64
1984,Applied Health Sciences,PROG MANAG,147,49,98
1985,Applied Health Sciences,PROG MANAG,159,60,99
1986,Applied Health Sciences,PROG MANAG,153,56,97
1987,Applied Health Sciences,PROG MANAG,145,51,94
1988,Applied Health Sciences,PROG MANAG,155,59,96
1989,Applied Health Sciences,PROG MANAG,136,54,82
1990,Applied Health Sciences,PROG MANAG,128,62,66
1991,Applied Health Sciences,PROG MANAG,157,76,81
1992,Applied Health Sciences,PROG MANAG,138,64,74
1993,Applied Health Sciences,PROG MANAG,92,43,49
1994,Applied Health Sciences,PROG MANAG,41,16,25
1995,Applied Health Sciences,PROG MANAG,18,6,12
1996,Applied Health Sciences,PROG MANAG,3,1,2
1997,Applied Health Sciences,PROG MANAG,46,19,27
1998,Applied Health Sciences,PROG MANAG,8,4,4
1999,Applied Health Sciences,PROG MANAG,2,1,1
1980,Applied Health Sciences,PROG SPEC,8,2,6
2018,LAS,Psychological Science,21,8,13
2017,LAS,Psychological Science,8,2,6
2018,LAS,Psychology,4,0,4
2018,LAS,Psychology,343,84,259
2018,LAS,Psychology,80,12,68
2018,LAS,Psychology,22,7,15
2018,LAS,Psychology,2,0,2
2018,LAS,Psychology,66,15,51
2018,LAS,Psychology,13,1,12
2018,LAS,Psychology,7,4,3
2018,LAS,Psychology,1,1,0
2018,LAS,Psychology,16,1,15
2018,LAS,Psychology,2,1,1
2018,LAS,Psychology,40,16,24
2018,LAS,Psychology,12,2,10
2018,LAS,Psychology,12,5,7
2018,LAS,Psychology,5,3,2
2018,LAS,Psychology,1,0,1
2018,LAS,Psychology,24,8,16
2018,LAS,Psychology,5,1,4
2018,LAS,Psychology,1,0,1
2018,LAS,Psychology,6,1,5
2018,LAS,Psychology,2,0,2
2018,LAS,Psychology,7,1,6
2018,LAS,Psychology,2,2,0
2018,LAS,Psychology,861,235,626
2018,LAS,Psychology,133,37,96
2017,LAS,Psychology,3,0,3
2017,LAS,Psychology,719,182,537
2017,LAS,Psychology,93,18,75
2017,LAS,Psychology,21,7,14
2017,LAS,Psychology,2,1,1
2017,LAS,Psychology,51,10,41
2017,LAS,Psychology,6,2,4
2017,LAS,Psychology,3,2,1
2017,LAS,Psychology,19,2,17
2017,LAS,Psychology,2,0,2
2017,LAS,Psychology,26,7,19
2017,LAS,Psychology,5,0,5
2017,LAS,Psychology,7,2,5
2017,LAS,Psychology,7,3,4
2017,LAS,Psychology,11,1,10
2017,LAS,Psychology,468,130,337
2017,LAS,Psychology,140,45,95
2016,LAS,Psychology,1269,318,951
2016,LAS,Psychology,124,38,86
2016,LAS,Psychology,4,2,2
2016,LAS,Psychology,1,0,1
2016,LAS,Psychology,1,0,1
2016,LAS,Psychology,1,0,1
2016,LAS,Psychology,1,1,0
2016,LAS,Psychology,10,5,5
2016,LAS,Psychology,2,0,2
2016,LAS,Psychology,1,1,0
2016,LAS,Psychology,1,1,0
2016,LAS,Psychology,141,46,95
2015,LAS,Psychology,109,37,72
2015,LAS,Psychology,147,53,94
2015,LAS,Psychology,1224,346,878
2014,LAS,Psychology,102,30,72
2014,LAS,Psychology,138,51,87
2014,LAS,Psychology,1159,342,817
2013,LAS,Psychology,6,2,4
2013,LAS,Psychology,1,0,1
2013,LAS,Psychology,141,55,86
2013,LAS,Psychology,85,20,64
2013,LAS,Psychology,1153,361,792
2012,LAS,Psychology,2,0,2
2012,LAS,Psychology,49,13,36
2012,LAS,Psychology,134,49,85
2012,LAS,Psychology,1203,354,849
2011,LAS,Psychology,4,0,4
2011,LAS,Psychology,46,11,35
2011,LAS,Psychology,139,49,90
2011,LAS,Psychology,1257,397,857
2010,LAS,Psychology,1,0,1
2010,LAS,Psychology,43,9,34
2010,LAS,Psychology,1,0,1
2010,LAS,Psychology,2,2,0
2010,LAS,Psychology,144,48,96
2010,LAS,Psychology,1255,407,845
2009,LAS,Psychology,1,0,1
2009,LAS,Psychology,2,2,0
2009,LAS,Psychology,1,0,1
2009,LAS,Psychology,25,5,20
2009,LAS,Psychology,1214,334,879
2009,LAS,Psychology,174,62,112
2008,LAS,Psychology,1,0,1
2008,LAS,Psychology,1,1,0
2008,LAS,Psychology,16,5,11
2008,LAS,Psychology,1246,340,906
2008,LAS,Psychology,173,60,113
2007,LAS,Psychology,2,1,1
2007,LAS,Psychology,19,10,9
2007,LAS,Psychology,3,1,2
2007,LAS,Psychology,1314,384,928
2007,LAS,Psychology,182,64,118
2006,LAS,Psychology,1,0,1
2006,LAS,Psychology,3,1,2
2006,LAS,Psychology,1,1,0
2006,LAS,Psychology,16,9,7
2006,LAS,Psychology,1245,336,908
2006,LAS,Psychology,185,64,121
2005,LAS,Psychology,1,0,1
2005,LAS,Psychology,1,1,0
2005,LAS,Psychology,20,10,10
2005,LAS,Psychology,1179,309,870
2005,LAS,Psychology,175,61,114
2004,LAS,Psychology,1,0,1
2004,LAS,Psychology,1179,312,867
2004,LAS,Psychology,3,2,1
2004,LAS,Psychology,178,59,119
1980,LAS,Psychology,152,82,70
1981,LAS,Psychology,160,82,78
1982,LAS,Psychology,183,96,87
1983,LAS,Psychology,182,91,91
1984,LAS,Psychology,189,92,97
1985,LAS,Psychology,193,98,95
1986,LAS,Psychology,202,109,93
1987,LAS,Psychology,191,101,90
1988,LAS,Psychology,209,106,103
1989,LAS,Psychology,200,112,88
1990,LAS,Psychology,195,105,90
1991,LAS,Psychology,195,99,96
1992,LAS,Psychology,217,101,116
1993,LAS,Psychology,224,99,125
1994,LAS,Psychology,193,82,111
1995,LAS,Psychology,205,84,121
1996,LAS,Psychology,191,84,107
1997,LAS,Psychology,173,75,98
1998,LAS,Psychology,166,74,92
1999,LAS,Psychology,159,74,85
2000,LAS,Psychology,168,68,100
2001,LAS,Psychology,152,63,89
2002,LAS,Psychology,174,62,112
2003,LAS,Psychology,193,69,124
1980,LAS,Psychology,8,4,4
1980,LAS,PUB ADMIN,19,12,7
1981,LAS,PUB ADMIN,12,8,4
1982,LAS,PUB ADMIN,13,9,4
1983,LAS,PUB ADMIN,20,14,6
1984,LAS,PUB ADMIN,11,5,6
1985,LAS,PUB ADMIN,9,5,4
1986,LAS,PUB ADMIN,6,5,1
1987,LAS,PUB ADMIN,6,4,2
1988,LAS,PUB ADMIN,6,3,3
1989,LAS,PUB ADMIN,3,2,1
2018,Applied Health Sciences,Public Health,20,4,16
2017,Applied Health Sciences,Public Health,26,4,22
2016,Applied Health Sciences,Public Health,29,8,21
2015,Applied Health Sciences,Public Health,24,4,20
2014,Applied Health Sciences,Public Health,28,8,20
2013,Applied Health Sciences,Public Health,36,11,25
2012,Applied Health Sciences,Public Health,32,8,24
2011,Applied Health Sciences,Public Health,30,8,22
2010,Applied Health Sciences,Public Health,13,5,8
2009,Applied Health Sciences,Public Health,5,3,2
1997,Applied Health Sciences,"Recreation, Sport, and Tourism ",27,12,15
1998,Applied Health Sciences,"Recreation, Sport, and Tourism ",39,20,19
1999,Applied Health Sciences,"Recreation, Sport, and Tourism ",32,18,14
2000,Applied Health Sciences,"Recreation, Sport, and Tourism ",33,14,19
2001,Applied Health Sciences,"Recreation, Sport, and Tourism ",33,12,21
2002,Applied Health Sciences,"Recreation, Sport, and Tourism ",42,13,29
2003,Applied Health Sciences,"Recreation, Sport, and Tourism ",34,14,20
2018,Applied Health Sciences,"Recreation, Sport, and Tourism ",32,26,6
2018,Applied Health Sciences,"Recreation, Sport, and Tourism ",18,7,11
2018,Applied Health Sciences,"Recreation, Sport, and Tourism ",28,13,15
2018,Applied Health Sciences,"Recreation, Sport, and Tourism ",187,142,45
2018,Applied Health Sciences,"Recreation, Sport, and Tourism ",31,21,10
2018,Applied Health Sciences,"Recreation, Sport, and Tourism ",28,15,13
2018,Applied Health Sciences,"Recreation, Sport, and Tourism ",3,3,0
2018,Applied Health Sciences,"Recreation, Sport, and Tourism ",32,16,16
2017,Applied Health Sciences,"Recreation, Sport, and Tourism ",17,11,6
2017,Applied Health Sciences,"Recreation, Sport, and Tourism ",27,11,16
2017,Applied Health Sciences,"Recreation, Sport, and Tourism ",29,12,17
2017,Applied Health Sciences,"Recreation, Sport, and Tourism ",1,1,0
2017,Applied Health Sciences,"Recreation, Sport, and Tourism ",199,152,47
2017,Applied Health Sciences,"Recreation, Sport, and Tourism ",28,17,11
2017,Applied Health Sciences,"Recreation, Sport, and Tourism ",35,15,20
2017,Applied Health Sciences,"Recreation, Sport, and Tourism ",27,11,16
2016,Applied Health Sciences,"Recreation, Sport, and Tourism ",64,53,11
2016,Applied Health Sciences,"Recreation, Sport, and Tourism ",33,14,19
2016,Applied Health Sciences,"Recreation, Sport, and Tourism ",19,7,12
2016,Applied Health Sciences,"Recreation, Sport, and Tourism ",161,121,40
2016,Applied Health Sciences,"Recreation, Sport, and Tourism ",28,18,10
2016,Applied Health Sciences,"Recreation, Sport, and Tourism ",2,1,1
2016,Applied Health Sciences,"Recreation, Sport, and Tourism ",26,12,14
2015,Applied Health Sciences,"Recreation, Sport, and Tourism ",22,8,14
2015,Applied Health Sciences,"Recreation, Sport, and Tourism ",30,10,20
2015,Applied Health Sciences,"Recreation, Sport, and Tourism ",24,11,13
2015,Applied Health Sciences,"Recreation, Sport, and Tourism ",55,44,11
2015,Applied Health Sciences,"Recreation, Sport, and Tourism ",28,11,17
2015,Applied Health Sciences,"Recreation, Sport, and Tourism ",158,127,31
2014,Applied Health Sciences,"Recreation, Sport, and Tourism ",36,10,26
2014,Applied Health Sciences,"Recreation, Sport, and Tourism ",23,8,15
2014,Applied Health Sciences,"Recreation, Sport, and Tourism ",20,8,12
2014,Applied Health Sciences,"Recreation, Sport, and Tourism ",64,43,21
2014,Applied Health Sciences,"Recreation, Sport, and Tourism ",25,10,15
2014,Applied Health Sciences,"Recreation, Sport, and Tourism ",177,139,38
2013,Applied Health Sciences,"Recreation, Sport, and Tourism ",1,0,1
2013,Applied Health Sciences,"Recreation, Sport, and Tourism ",4,3,1
2013,Applied Health Sciences,"Recreation, Sport, and Tourism ",25,12,13
2013,Applied Health Sciences,"Recreation, Sport, and Tourism ",24,10,14
2013,Applied Health Sciences,"Recreation, Sport, and Tourism ",30,10,20
2013,Applied Health Sciences,"Recreation, Sport, and Tourism ",34,10,24
2013,Applied Health Sciences,"Recreation, Sport, and Tourism ",65,46,19
2013,Applied Health Sciences,"Recreation, Sport, and Tourism ",163,121,42
2012,Applied Health Sciences,"Recreation, Sport, and Tourism ",26,14,12
2012,Applied Health Sciences,"Recreation, Sport, and Tourism ",27,13,14
2012,Applied Health Sciences,"Recreation, Sport, and Tourism ",34,10,24
2012,Applied Health Sciences,"Recreation, Sport, and Tourism ",30,9,21
2012,Applied Health Sciences,"Recreation, Sport, and Tourism ",34,23,11
2012,Applied Health Sciences,"Recreation, Sport, and Tourism ",74,42,32
2012,Applied Health Sciences,"Recreation, Sport, and Tourism ",144,114,30
2011,Applied Health Sciences,"Recreation, Sport, and Tourism ",44,11,33
2011,Applied Health Sciences,"Recreation, Sport, and Tourism ",21,10,11
2011,Applied Health Sciences,"Recreation, Sport, and Tourism ",28,15,13
2011,Applied Health Sciences,"Recreation, Sport, and Tourism ",32,10,22
2011,Applied Health Sciences,"Recreation, Sport, and Tourism ",82,65,17
2011,Applied Health Sciences,"Recreation, Sport, and Tourism ",75,55,20
2011,Applied Health Sciences,"Recreation, Sport, and Tourism ",92,76,16
2010,Applied Health Sciences,"Recreation, Sport, and Tourism ",31,15,16
2010,Applied Health Sciences,"Recreation, Sport, and Tourism ",6,5,1
2010,Applied Health Sciences,"Recreation, Sport, and Tourism ",92,53,39
2010,Applied Health Sciences,"Recreation, Sport, and Tourism ",31,16,15
2010,Applied Health Sciences,"Recreation, Sport, and Tourism ",36,16,20
2010,Applied Health Sciences,"Recreation, Sport, and Tourism ",36,11,25
2010,Applied Health Sciences,"Recreation, Sport, and Tourism ",145,121,23
2009,Applied Health Sciences,"Recreation, Sport, and Tourism ",56,28,28
2009,Applied Health Sciences,"Recreation, Sport, and Tourism ",39,15,24
2009,Applied Health Sciences,"Recreation, Sport, and Tourism ",38,26,12
2009,Applied Health Sciences,"Recreation, Sport, and Tourism ",108,67,41
2009,Applied Health Sciences,"Recreation, Sport, and Tourism ",27,11,16
2009,Applied Health Sciences,"Recreation, Sport, and Tourism ",161,131,29
2008,Applied Health Sciences,"Recreation, Sport, and Tourism ",47,12,35
2008,Applied Health Sciences,"Recreation, Sport, and Tourism ",49,29,20
2008,Applied Health Sciences,"Recreation, Sport, and Tourism ",37,23,14
2008,Applied Health Sciences,"Recreation, Sport, and Tourism ",99,70,29
2008,Applied Health Sciences,"Recreation, Sport, and Tourism ",28,9,19
2008,Applied Health Sciences,"Recreation, Sport, and Tourism ",163,129,33
2007,Applied Health Sciences,"Recreation, Sport, and Tourism ",47,25,22
2007,Applied Health Sciences,"Recreation, Sport, and Tourism ",52,11,41
2007,Applied Health Sciences,"Recreation, Sport, and Tourism ",38,21,17
2007,Applied Health Sciences,"Recreation, Sport, and Tourism ",111,73,37
2007,Applied Health Sciences,"Recreation, Sport, and Tourism ",144,115,29
2007,Applied Health Sciences,"Recreation, Sport, and Tourism ",25,8,17
2006,Applied Health Sciences,"Recreation, Sport, and Tourism ",30,15,15
2006,Applied Health Sciences,"Recreation, Sport, and Tourism ",23,2,21
2006,Applied Health Sciences,"Recreation, Sport, and Tourism ",36,22,14
2006,Applied Health Sciences,"Recreation, Sport, and Tourism ",14,5,9
2006,Applied Health Sciences,"Recreation, Sport, and Tourism ",93,58,35
2006,Applied Health Sciences,"Recreation, Sport, and Tourism ",94,70,23
2005,Applied Health Sciences,"Recreation, Sport, and Tourism ",5,3,2
2005,Applied Health Sciences,"Recreation, Sport, and Tourism ",5,5,0
2005,Applied Health Sciences,"Recreation, Sport, and Tourism ",22,13,9
2005,Applied Health Sciences,"Recreation, Sport, and Tourism ",4,1,3
1995,LAS,REES,6,3,3
1996,LAS,REES,7,3,4
1997,LAS,REES,4,1,3
1998,LAS,REES,5,1,4
1999,LAS,REES,5,1,4
2000,LAS,REES,4,3,1
2001,LAS,REES,7,4,3
2002,LAS,REES,7,3,4
2003,LAS,REES,7,2,5
1984,Fine and Applied Arts,Regional Planning,3,2,1
1986,Fine and Applied Arts,Regional Planning,10,9,1
1987,Fine and Applied Arts,Regional Planning,13,11,2
1988,Fine and Applied Arts,Regional Planning,16,12,4
1989,Fine and Applied Arts,Regional Planning,20,16,4
1990,Fine and Applied Arts,Regional Planning,16,12,4
1991,Fine and Applied Arts,Regional Planning,22,15,7
1992,Fine and Applied Arts,Regional Planning,25,15,10
1993,Fine and Applied Arts,Regional Planning,29,19,10
1994,Fine and Applied Arts,Regional Planning,27,19,8
1995,Fine and Applied Arts,Regional Planning,25,17,8
1996,Fine and Applied Arts,Regional Planning,16,11,5
1997,Fine and Applied Arts,Regional Planning,10,8,2
1998,Fine and Applied Arts,Regional Planning,15,9,6
1999,Fine and Applied Arts,Regional Planning,18,8,10
2000,Fine and Applied Arts,Regional Planning,22,12,10
2001,Fine and Applied Arts,Regional Planning,23,12,11
2002,Fine and Applied Arts,Regional Planning,20,11,9
2003,Fine and Applied Arts,Regional Planning,32,21,11
2018,Fine and Applied Arts,Regional Planning,16,10,6
2017,Fine and Applied Arts,Regional Planning,15,10,5
2016,Fine and Applied Arts,Regional Planning,17,10,7
2015,Fine and Applied Arts,Regional Planning,15,9,6
2014,Fine and Applied Arts,Regional Planning,19,14,5
2013,Fine and Applied Arts,Regional Planning,19,11,8
2012,Fine and Applied Arts,Regional Planning,21,13,8
2011,Fine and Applied Arts,Regional Planning,23,13,10
2010,Fine and Applied Arts,Regional Planning,24,15,9
2009,Fine and Applied Arts,Regional Planning,25,14,11
2008,Fine and Applied Arts,Regional Planning,19,12,7
2007,Fine and Applied Arts,Regional Planning,20,10,10
2006,Fine and Applied Arts,Regional Planning,26,14,12
2005,Fine and Applied Arts,Regional Planning,28,16,12
2004,Fine and Applied Arts,Regional Planning,25,16,9
2002,Applied Health Sciences,REHAB STUDIES,4,1,3
2003,Applied Health Sciences,REHAB STUDIES,23,4,19
1989,Applied Health Sciences,Rehabilitation,11,4,7
1990,Applied Health Sciences,Rehabilitation,11,3,8
1991,Applied Health Sciences,Rehabilitation,19,6,13
1992,Applied Health Sciences,Rehabilitation,29,8,21
1993,Applied Health Sciences,Rehabilitation,29,8,21
1994,Applied Health Sciences,Rehabilitation,28,9,19
1995,Applied Health Sciences,Rehabilitation,32,5,27
1996,Applied Health Sciences,Rehabilitation,25,5,20
1997,Applied Health Sciences,Rehabilitation,8,3,5
1998,Applied Health Sciences,Rehabilitation,16,3,13
1999,Applied Health Sciences,Rehabilitation,9,4,5
2000,Applied Health Sciences,Rehabilitation,9,3,6
2001,Applied Health Sciences,Rehabilitation,9,2,7
2002,Applied Health Sciences,Rehabilitation,11,4,7
2003,Applied Health Sciences,Rehabilitation,6,1,5
2017,Applied Health Sciences,Rehabilitation,3,2,1
2016,Applied Health Sciences,Rehabilitation,3,2,1
2015,Applied Health Sciences,Rehabilitation,1,1,0
2013,Applied Health Sciences,Rehabilitation,1,0,1
2012,Applied Health Sciences,Rehabilitation,5,1,4
2011,Applied Health Sciences,Rehabilitation,10,3,7
2010,Applied Health Sciences,Rehabilitation,6,2,4
2009,Applied Health Sciences,Rehabilitation,4,2,2
2008,Applied Health Sciences,Rehabilitation,5,0,5
2007,Applied Health Sciences,Rehabilitation,6,0,6
2006,Applied Health Sciences,Rehabilitation,4,1,3
2005,Applied Health Sciences,Rehabilitation,6,1,5
2004,Applied Health Sciences,Rehabilitation,6,0,6
2018,LAS,Religion,3,2,1
2018,LAS,Religion,9,2,7
2017,LAS,Religion,1,1,0
2017,LAS,Religion,1,1,0
2017,LAS,Religion,8,2,6
2016,LAS,Religion,8,4,4
2016,LAS,Religion,5,2,3
2015,LAS,Religion,7,4,3
2015,LAS,Religion,9,7,2
2014,LAS,Religion,1,0,1
2014,LAS,Religion,5,3,2
2014,LAS,Religion,14,11,3
2013,LAS,Religion,1,0,1
2013,LAS,Religion,1,1,0
2013,LAS,Religion,1,1,0
2013,LAS,Religion,10,7,3
2013,LAS,Religion,1,1,0
2013,LAS,Religion,8,6,2
2012,LAS,Religion,1,1,0
2012,LAS,Religion,6,5,1
2012,LAS,Religion,10,5,5
2012,LAS,Religion,3,2,1
2011,LAS,Religion,13,7,6
2011,LAS,Religion,1,1,0
2011,LAS,Religion,1,1,0
2011,LAS,Religion,1,1,0
2011,LAS,Religion,3,2,1
2010,LAS,Religion,9,6,3
2010,LAS,Religion,3,1,2
2010,LAS,Religion,1,1,0
2010,LAS,Religion,2,0,2
2009,LAS,Religion,4,2,2
2009,LAS,Religion,1,0,1
2009,LAS,Religion,1,0,1
2013,LAS,Religious Studies,1,0,1
2012,LAS,Religious Studies,1,0,1
2012,LAS,Religious Studies,1,1,0
2011,LAS,Religious Studies,2,1,1
2011,LAS,Religious Studies,1,0,1
2011,LAS,Religious Studies,2,0,2
2010,LAS,Religious Studies,5,1,4
2010,LAS,Religious Studies,1,0,1
2010,LAS,Religious Studies,1,1,0
2010,LAS,Religious Studies,1,1,0
2009,LAS,Religious Studies,15,6,9
2009,LAS,Religious Studies,1,1,0
2009,LAS,Religious Studies,3,2,1
2008,LAS,Religious Studies,2,1,1
2008,LAS,Religious Studies,1,0,1
2008,LAS,Religious Studies,1,1,0
2008,LAS,Religious Studies,2,1,1
2008,LAS,Religious Studies,1,1,0
2008,LAS,Religious Studies,16,8,8
2007,LAS,Religious Studies,17,8,9
2007,LAS,Religious Studies,1,1,0
2007,LAS,Religious Studies,1,1,0
2007,LAS,Religious Studies,1,1,0
2007,LAS,Religious Studies,3,2,1
2007,LAS,Religious Studies,1,0,1
2007,LAS,Religious Studies,1,1,0
2006,LAS,Religious Studies,21,14,7
2006,LAS,Religious Studies,1,1,0
2006,LAS,Religious Studies,1,0,1
2005,LAS,Religious Studies,1,1,0
2005,LAS,Religious Studies,1,1,0
2005,LAS,Religious Studies,4,1,3
2005,LAS,Religious Studies,23,14,9
2004,LAS,Religious Studies,17,10,7
2004,LAS,Religious Studies,1,0,1
2004,LAS,Religious Studies,2,1,1
2004,LAS,Religious Studies,1,0,1
1980,ACES,REST MGMT,53,30,23
1981,ACES,REST MGMT,52,33,19
1982,ACES,REST MGMT,56,32,24
1983,ACES,REST MGMT,57,28,29
1984,ACES,REST MGMT,79,39,40
1985,ACES,REST MGMT,87,40,47
1986,ACES,REST MGMT,97,45,52
1987,ACES,REST MGMT,110,53,57
1988,ACES,REST MGMT,126,61,65
1989,ACES,REST MGMT,108,60,48
1990,ACES,REST MGMT,116,63,53
1991,ACES,REST MGMT,101,54,47
1992,ACES,REST MGMT,74,35,39
1993,ACES,REST MGMT,75,29,46
1994,ACES,REST MGMT,61,26,35
1995,ACES,REST MGMT,49,18,31
1996,ACES,REST MGMT,60,27,33
1997,ACES,REST MGMT,23,12,11
1998,ACES,REST MGMT,13,7,6
1999,ACES,REST MGMT,5,2,3
2017,LAS,Rhetoric,1,1,0
2016,LAS,Rhetoric,1,1,0
2015,LAS,Rhetoric,2,0,2
2015,LAS,Rhetoric,6,3,3
2014,LAS,Rhetoric,3,3,0
2014,LAS,Rhetoric,7,2,5
2014,LAS,Rhetoric,24,8,16
2013,LAS,Rhetoric,8,4,4
2013,LAS,Rhetoric,1,1,0
2013,LAS,Rhetoric,8,2,6
2013,LAS,Rhetoric,43,12,31
2012,LAS,Rhetoric,2,1,1
2012,LAS,Rhetoric,1,0,1
2012,LAS,Rhetoric,10,3,7
2012,LAS,Rhetoric,10,3,7
2012,LAS,Rhetoric,70,28,42
2011,LAS,Rhetoric,4,1,3
2011,LAS,Rhetoric,10,3,7
2011,LAS,Rhetoric,93,45,48
2010,LAS,Rhetoric,5,3,2
2010,LAS,Rhetoric,1,1,0
2010,LAS,Rhetoric,9,3,6
2010,LAS,Rhetoric,93,55,38
2009,LAS,Rhetoric,6,1,5
2009,LAS,Rhetoric,8,2,6
2009,LAS,Rhetoric,104,57,47
2008,LAS,Rhetoric,11,3,8
2008,LAS,Rhetoric,1,0,1
2008,LAS,Rhetoric,3,1,2
2008,LAS,Rhetoric,104,56,48
2007,LAS,Rhetoric,36,16,20
2007,LAS,Rhetoric,1,0,1
2007,LAS,Rhetoric,2,1,1
2007,LAS,Rhetoric,1,0,1
2007,LAS,Rhetoric,68,32,36
2006,LAS,Rhetoric,4,1,3
2006,LAS,Rhetoric,4,1,3
2006,LAS,Rhetoric,39,15,24
2006,LAS,Rhetoric,62,34,28
2005,LAS,Rhetoric,11,5,6
2005,LAS,Rhetoric,4,3,1
2005,LAS,Rhetoric,39,23,16
2005,LAS,Rhetoric,80,41,39
2004,LAS,Rhetoric,112,59,53
2004,LAS,Rhetoric,1,1,0
2004,LAS,Rhetoric,19,9,10
2004,LAS,Rhetoric,6,3,3
2013,LAS,Russian & E European Studies,1,0,1
2012,LAS,Russian & E European Studies,1,0,1
2011,LAS,Russian & E European Studies,2,1,1
2010,LAS,Russian & E European Studies,4,4,0
2009,LAS,Russian & E European Studies,5,4,1
2008,LAS,Russian & E European Studies,1,0,1
2008,LAS,Russian & E European Studies,3,2,1
2007,LAS,Russian & E European Studies,1,1,0
2007,LAS,Russian & E European Studies,5,3,2
2006,LAS,Russian & E European Studies,5,4,1
2006,LAS,Russian & E European Studies,7,5,2
2005,LAS,Russian & E European Studies,4,4,0
2005,LAS,Russian & E European Studies,8,4,4
2004,LAS,Russian & E European Studies,3,3,0
2004,LAS,Russian & E European Studies,8,2,6
2016,LAS,Russian Lang & Literature,1,1,0
2015,LAS,Russian Lang & Literature,1,1,0
2015,LAS,Russian Lang & Literature,1,0,1
2014,LAS,Russian Lang & Literature,1,0,1
2014,LAS,Russian Lang & Literature,4,3,1
2013,LAS,Russian Lang & Literature,5,4,1
2013,LAS,Russian Lang & Literature,1,0,1
2012,LAS,Russian Lang & Literature,5,2,3
2011,LAS,Russian Lang & Literature,3,1,2
2010,LAS,Russian Lang & Literature,4,3,1
2009,LAS,Russian Lang & Literature,4,2,2
2008,LAS,Russian Lang & Literature,4,2,2
2007,LAS,Russian Lang & Literature,4,1,3
2006,LAS,Russian Lang & Literature,6,2,4
2005,LAS,Russian Lang & Literature,4,1,3
2004,LAS,Russian Lang & Literature,3,2,1
2018,LAS,"Russian, E Eur, Eurasian St ",4,1,3
2018,LAS,"Russian, E Eur, Eurasian St ",2,0,2
2018,LAS,"Russian, E Eur, Eurasian St ",4,2,2
2017,LAS,"Russian, E Eur, Eurasian St ",9,5,4
2017,LAS,"Russian, E Eur, Eurasian St ",1,0,1
2017,LAS,"Russian, E Eur, Eurasian St ",6,1,5
2016,LAS,"Russian, E Eur, Eurasian St ",7,4,3
2016,LAS,"Russian, E Eur, Eurasian St ",7,3,4
2015,LAS,"Russian, E Eur, Eurasian St ",4,1,3
2015,LAS,"Russian, E Eur, Eurasian St ",8,3,5
2014,LAS,"Russian, E Eur, Eurasian St ",1,0,1
2014,LAS,"Russian, E Eur, Eurasian St ",10,5,5
2014,LAS,"Russian, E Eur, Eurasian St ",8,2,6
2013,LAS,"Russian, E Eur, Eurasian St ",4,2,2
2013,LAS,"Russian, E Eur, Eurasian St ",6,3,3
2012,LAS,"Russian, E Eur, Eurasian St ",3,2,1
2012,LAS,"Russian, E Eur, Eurasian St ",3,1,2
2011,LAS,"Russian, E Eur, Eurasian St ",3,2,1
2011,LAS,"Russian, E Eur, Eurasian St ",3,1,2
2010,LAS,"Russian, E Eur, Eurasian St ",6,6,0
2010,LAS,"Russian, E Eur, Eurasian St ",7,2,5
2009,LAS,"Russian, E Eur, Eurasian St ",5,4,1
2009,LAS,"Russian, E Eur, Eurasian St ",13,9,4
2008,LAS,"Russian, E Eur, Eurasian St ",1,0,1
2008,LAS,"Russian, E Eur, Eurasian St ",10,9,1
2007,LAS,"Russian, E Eur, Eurasian St ",7,6,1
2006,LAS,"Russian, E Eur, Eurasian St ",3,3,0
2017,LAS,S Asian & Middle Eastern St,3,2,1
2016,LAS,S Asian & Middle Eastern St,5,4,1
2015,LAS,S Asian & Middle Eastern St,3,3,0
2014,LAS,S Asian & Middle Eastern St,5,4,1
2013,LAS,S Asian & Middle Eastern St,2,1,1
1980,Applied Health Sciences,SCH HEALTH,18,2,16
1981,Applied Health Sciences,SCH HEALTH,15,4,11
1982,Applied Health Sciences,SCH HEALTH,14,5,9
1983,Applied Health Sciences,SCH HEALTH,4,1,3
2018,Fine and Applied Arts,Sculpture,3,2,1
2017,Fine and Applied Arts,Sculpture,2,1,1
2016,Fine and Applied Arts,Sculpture,2,0,2
2015,Fine and Applied Arts,Sculpture,1,0,1
2014,Fine and Applied Arts,Sculpture,3,2,1
2013,Fine and Applied Arts,Sculpture,5,2,3
2012,Fine and Applied Arts,Sculpture,8,2,6
2011,Fine and Applied Arts,Sculpture,6,4,2
2010,Fine and Applied Arts,Sculpture,3,1,2
2009,Fine and Applied Arts,Sculpture,5,1,4
2008,Fine and Applied Arts,Sculpture,10,2,8
2007,Fine and Applied Arts,Sculpture,12,4,8
2006,Fine and Applied Arts,Sculpture,12,7,5
2005,Fine and Applied Arts,Sculpture,15,8,7
2004,Fine and Applied Arts,Sculpture,17,8,9
1999,Education,Secondary & Continuing Educ,10,8,2
2000,Education,Secondary & Continuing Educ,7,6,1
2001,Education,Secondary & Continuing Educ,5,3,2
2002,Education,Secondary & Continuing Educ,7,3,4
2003,Education,Secondary & Continuing Educ,6,4,2
1996,Education,Secondary & Continuing Educ,6,4,2
1997,Education,Secondary & Continuing Educ,10,7,3
1998,Education,Secondary & Continuing Educ,9,6,3
2000,Education,Secondary & Continuing Educ,10,6,4
2001,Education,Secondary & Continuing Educ,13,8,5
2002,Education,Secondary & Continuing Educ,6,3,3
2003,Education,Secondary & Continuing Educ,4,1,3
1996,Education,Secondary & Continuing Educ,11,4,7
1997,Education,Secondary & Continuing Educ,8,3,5
2000,Education,Secondary & Continuing Educ,7,2,5
2001,Education,Secondary & Continuing Educ,7,3,4
2002,Education,Secondary & Continuing Educ,7,2,5
2003,Education,Secondary & Continuing Educ,11,3,8
1996,Education,Secondary & Continuing Educ,5,2,3
1997,Education,Secondary & Continuing Educ,5,2,3
1998,Education,Secondary & Continuing Educ,7,4,3
1999,Education,Secondary & Continuing Educ,8,5,3
2000,Education,Secondary & Continuing Educ,10,5,5
2001,Education,Secondary & Continuing Educ,12,7,5
2002,Education,Secondary & Continuing Educ,10,5,5
2003,Education,Secondary & Continuing Educ,9,4,5
2015,Education,Secondary & Continuing Educ,1,1,0
2014,Education,Secondary & Continuing Educ,2,0,2
2013,Education,Secondary & Continuing Educ,9,2,7
2012,Education,Secondary & Continuing Educ,17,4,13
2011,Education,Secondary & Continuing Educ,1,0,1
2011,Education,Secondary & Continuing Educ,24,7,17
2010,Education,Secondary & Continuing Educ,1,0,1
2010,Education,Secondary & Continuing Educ,32,12,20
2009,Education,Secondary & Continuing Educ,1,0,1
2009,Education,Secondary & Continuing Educ,1,1,0
2009,Education,Secondary & Continuing Educ,2,0,2
2009,Education,Secondary & Continuing Educ,50,17,33
2008,Education,Secondary & Continuing Educ,5,2,3
2008,Education,Secondary & Continuing Educ,1,1,0
2008,Education,Secondary & Continuing Educ,4,3,1
2008,Education,Secondary & Continuing Educ,3,2,1
2008,Education,Secondary & Continuing Educ,2,0,2
2008,Education,Secondary & Continuing Educ,7,1,6
2008,Education,Secondary & Continuing Educ,4,3,1
2008,Education,Secondary & Continuing Educ,60,23,37
2007,Education,Secondary & Continuing Educ,1,0,1
2007,Education,Secondary & Continuing Educ,4,1,3
2007,Education,Secondary & Continuing Educ,4,3,1
2007,Education,Secondary & Continuing Educ,9,5,4
2007,Education,Secondary & Continuing Educ,7,2,5
2007,Education,Secondary & Continuing Educ,12,3,9
2007,Education,Secondary & Continuing Educ,3,0,3
2007,Education,Secondary & Continuing Educ,3,2,1
2007,Education,Secondary & Continuing Educ,77,28,49
2006,Education,Secondary & Continuing Educ,1,0,1
2006,Education,Secondary & Continuing Educ,1,0,1
2006,Education,Secondary & Continuing Educ,1,1,0
2006,Education,Secondary & Continuing Educ,4,1,3
2006,Education,Secondary & Continuing Educ,6,5,1
2006,Education,Secondary & Continuing Educ,11,5,6
2006,Education,Secondary & Continuing Educ,6,1,5
2006,Education,Secondary & Continuing Educ,14,1,13
2006,Education,Secondary & Continuing Educ,62,24,38
2005,Education,Secondary & Continuing Educ,3,2,1
2005,Education,Secondary & Continuing Educ,7,5,2
2005,Education,Secondary & Continuing Educ,11,5,6
2005,Education,Secondary & Continuing Educ,3,1,2
2005,Education,Secondary & Continuing Educ,5,2,3
2005,Education,Secondary & Continuing Educ,7,5,2
2005,Education,Secondary & Continuing Educ,9,3,6
2005,Education,Secondary & Continuing Educ,67,25,42
2004,Education,Secondary & Continuing Educ,45,16,29
2004,Education,Secondary & Continuing Educ,20,5,15
2004,Education,Secondary & Continuing Educ,1,0,1
2004,Education,Secondary & Continuing Educ,8,3,5
2004,Education,Secondary & Continuing Educ,5,3,2
2004,Education,Secondary & Continuing Educ,15,5,10
2004,Education,Secondary & Continuing Educ,7,6,1
2004,Education,Secondary & Continuing Educ,2,1,1
2004,Education,Secondary & Continuing Educ,1,1,0
2004,Education,Secondary & Continuing Educ,18,6,12
2018,Education,Secondary Education,1,1,0
2018,Education,Secondary Education,4,1,3
2018,Education,Secondary Education,6,5,1
2018,Education,Secondary Education,7,4,3
2018,Education,Secondary Education,2,2,0
2017,Education,Secondary Education,6,1,5
2017,Education,Secondary Education,6,5,1
2017,Education,Secondary Education,5,4,1
2017,Education,Secondary Education,2,1,1
2016,Education,Secondary Education,5,2,3
2016,Education,Secondary Education,3,2,1
2016,Education,Secondary Education,11,6,5
2016,Education,Secondary Education,3,2,1
2015,Education,Secondary Education,1,0,1
2015,Education,Secondary Education,3,2,1
2015,Education,Secondary Education,4,3,1
2015,Education,Secondary Education,12,6,6
2015,Education,Secondary Education,2,1,1
2014,Education,Secondary Education,1,0,1
2014,Education,Secondary Education,2,1,1
2014,Education,Secondary Education,2,2,0
2014,Education,Secondary Education,5,3,2
2014,Education,Secondary Education,1,0,1
2013,Education,Secondary Education,1,0,1
2013,Education,Secondary Education,1,0,1
2013,Education,Secondary Education,6,5,1
2013,Education,Secondary Education,3,2,1
2013,Education,Secondary Education,2,1,1
2012,Education,Secondary Education,1,1,0
2012,Education,Secondary Education,4,1,3
2012,Education,Secondary Education,6,4,2
2012,Education,Secondary Education,4,2,2
2012,Education,Secondary Education,1,1,0
2011,Education,Secondary Education,2,1,1
2011,Education,Secondary Education,3,1,2
2011,Education,Secondary Education,2,0,2
2011,Education,Secondary Education,1,0,1
2010,Education,Secondary Education,1,0,1
2010,Education,Secondary Education,3,0,3
2010,Education,Secondary Education,2,2,0
2010,Education,Secondary Education,2,2,0
2010,Education,Secondary Education,5,2,3
2009,Education,Secondary Education,3,1,2
2009,Education,Secondary Education,2,2,0
2009,Education,Secondary Education,5,2,3
2009,Education,Secondary Education,6,0,6
2009,Education,Secondary Education,5,4,1
2008,Education,Secondary Education,3,1,2
2018,LAS,Slavic Languages & Literature,1,1,0
2018,LAS,Slavic Languages & Literature,13,2,11
2017,LAS,Slavic Languages & Literature,15,3,12
2016,LAS,Slavic Languages & Literature,17,3,14
2015,LAS,Slavic Languages & Literature,14,4,10
2014,LAS,Slavic Languages & Literature,17,3,14
2013,LAS,Slavic Languages & Literature,1,0,1
2013,LAS,Slavic Languages & Literature,15,2,13
2012,LAS,Slavic Languages & Literature,3,1,2
2012,LAS,Slavic Languages & Literature,13,1,12
2011,LAS,Slavic Languages & Literature,10,1,9
2011,LAS,Slavic Languages & Literature,5,1,4
2010,LAS,Slavic Languages & Literature,9,1,8
2010,LAS,Slavic Languages & Literature,5,1,4
2009,LAS,Slavic Languages & Literature,7,1,6
2009,LAS,Slavic Languages & Literature,6,1,5
2008,LAS,Slavic Languages & Literature,4,1,3
2008,LAS,Slavic Languages & Literature,4,1,3
2007,LAS,Slavic Languages & Literature,1,0,1
2007,LAS,Slavic Languages & Literature,4,2,2
2007,LAS,Slavic Languages & Literature,5,2,3
2006,LAS,Slavic Languages & Literature,3,2,1
2006,LAS,Slavic Languages & Literature,5,2,3
2005,LAS,Slavic Languages & Literature,1,1,0
2005,LAS,Slavic Languages & Literature,3,1,2
2004,LAS,Slavic Languages & Literature,1,0,1
2004,LAS,Slavic Languages & Literature,1,1,0
1980,LAS,Slavic Languages & Literature,13,6,7
1981,LAS,Slavic Languages & Literature,14,4,10
1982,LAS,Slavic Languages & Literature,20,5,15
1983,LAS,Slavic Languages & Literature,20,6,14
1984,LAS,Slavic Languages & Literature,19,7,12
1985,LAS,Slavic Languages & Literature,19,9,10
1986,LAS,Slavic Languages & Literature,25,10,15
1987,LAS,Slavic Languages & Literature,26,10,16
1988,LAS,Slavic Languages & Literature,24,14,10
1989,LAS,Slavic Languages & Literature,28,15,13
1990,LAS,Slavic Languages & Literature,24,11,13
1991,LAS,Slavic Languages & Literature,26,17,9
1992,LAS,Slavic Languages & Literature,29,13,16
1993,LAS,Slavic Languages & Literature,27,10,17
1994,LAS,Slavic Languages & Literature,24,11,13
1995,LAS,Slavic Languages & Literature,20,8,12
1996,LAS,Slavic Languages & Literature,16,7,9
1997,LAS,Slavic Languages & Literature,16,8,8
1998,LAS,Slavic Languages & Literature,12,7,5
1999,LAS,Slavic Languages & Literature,11,7,4
2000,LAS,Slavic Languages & Literature,8,6,2
2001,LAS,Slavic Languages & Literature,7,5,2
2002,LAS,Slavic Languages & Literature,6,4,2
2003,LAS,Slavic Languages & Literature,4,3,1
2018,LAS,Slavic Studies,1,1,0
2018,LAS,Slavic Studies,3,1,2
2018,LAS,Slavic Studies,1,1,0
2017,LAS,Slavic Studies,1,1,0
2016,LAS,Slavic Studies,1,1,0
2015,LAS,Slavic Studies,1,1,0
1980,Applied Health Sciences,SOC SCI SP,13,8,5
1981,Applied Health Sciences,SOC SCI SP,5,3,2
1982,Applied Health Sciences,SOC SCI SP,8,3,5
1983,Applied Health Sciences,SOC SCI SP,10,8,2
1984,Applied Health Sciences,SOC SCI SP,9,6,3
1985,Applied Health Sciences,SOC SCI SP,8,4,4
1986,Applied Health Sciences,SOC SCI SP,13,7,6
1987,Applied Health Sciences,SOC SCI SP,13,7,6
1988,Applied Health Sciences,SOC SCI SP,21,15,6
1989,Applied Health Sciences,SOC SCI SP,13,10,3
1990,Applied Health Sciences,SOC SCI SP,16,14,2
1991,Applied Health Sciences,SOC SCI SP,12,8,4
1992,Applied Health Sciences,SOC SCI SP,13,10,3
1993,Applied Health Sciences,SOC SCI SP,6,4,2
1994,Applied Health Sciences,SOC SCI SP,5,3,2
1981,LAS,SOCIAL SCI,2,1,1
1982,LAS,SOCIAL SCI,3,1,2
1983,LAS,SOCIAL SCI,4,2,2
1984,LAS,SOCIAL SCI,3,2,1
2018,Social Work,Social Work,253,35,218
2018,Social Work,Social Work,1,1,0
2018,Social Work,Social Work,2,1,1
2018,Social Work,Social Work,1,0,1
2018,Social Work,Social Work,1,0,1
2018,Social Work,Social Work,2,0,2
2018,Social Work,Social Work,1,0,1
2018,Social Work,Social Work,2,1,1
2018,Social Work,Social Work,178,28,150
2018,Social Work,Social Work,107,10,97
2018,Social Work,Social Work,23,2,21
2018,Social Work,Social Work,6,1,5
2018,Social Work,Social Work,1,0,1
2018,Social Work,Social Work,6,0,6
2018,Social Work,Social Work,23,7,16
2017,Social Work,Social Work,263,37,226
2017,Social Work,Social Work,2,0,2
2017,Social Work,Social Work,1,0,1
2017,Social Work,Social Work,1,1,0
2017,Social Work,Social Work,3,0,3
2017,Social Work,Social Work,7,2,5
2017,Social Work,Social Work,20,2,18
2017,Social Work,Social Work,1,0,1
2017,Social Work,Social Work,3,0,3
2017,Social Work,Social Work,1,0,1
2017,Social Work,Social Work,8,2,6
2017,Social Work,Social Work,156,16,140
2017,Social Work,Social Work,67,10,57
2017,Social Work,Social Work,17,4,13
2017,Social Work,Social Work,2,0,2
2017,Social Work,Social Work,2,0,2
2017,Social Work,Social Work,6,0,6
2017,Social Work,Social Work,26,10,16
2016,Social Work,Social Work,267,32,235
2016,Social Work,Social Work,5,0,5
2016,Social Work,Social Work,14,3,11
2016,Social Work,Social Work,37,5,32
2016,Social Work,Social Work,23,2,21
2016,Social Work,Social Work,5,2,3
2016,Social Work,Social Work,10,1,9
2016,Social Work,Social Work,101,9,92
2016,Social Work,Social Work,12,2,10
2016,Social Work,Social Work,10,3,7
2016,Social Work,Social Work,27,10,17
2015,Social Work,Social Work,4,0,4
2015,Social Work,Social Work,4,1,3
2015,Social Work,Social Work,46,4,42
2015,Social Work,Social Work,34,5,29
2015,Social Work,Social Work,18,3,15
2015,Social Work,Social Work,29,3,26
2015,Social Work,Social Work,89,10,79
2015,Social Work,Social Work,218,22,196
2015,Social Work,Social Work,26,8,18
2014,Social Work,Social Work,1,0,1
2014,Social Work,Social Work,3,0,3
2014,Social Work,Social Work,8,2,6
2014,Social Work,Social Work,28,2,26
2014,Social Work,Social Work,15,3,12
2014,Social Work,Social Work,36,2,34
2014,Social Work,Social Work,44,5,39
2014,Social Work,Social Work,173,23,150
2014,Social Work,Social Work,84,9,75
2014,Social Work,Social Work,22,7,15
2013,Social Work,Social Work,3,0,3
2013,Social Work,Social Work,18,1,17
2013,Social Work,Social Work,24,5,19
2013,Social Work,Social Work,43,3,40
2013,Social Work,Social Work,9,1,8
2013,Social Work,Social Work,36,2,34
2013,Social Work,Social Work,31,3,28
2013,Social Work,Social Work,96,16,80
2013,Social Work,Social Work,143,17,126
2012,Social Work,Social Work,24,5,19
2012,Social Work,Social Work,19,4,15
2012,Social Work,Social Work,45,5,40
2012,Social Work,Social Work,23,4,19
2012,Social Work,Social Work,24,1,23
2012,Social Work,Social Work,40,8,32
2012,Social Work,Social Work,67,11,56
2012,Social Work,Social Work,113,10,103
2011,Social Work,Social Work,25,4,21
2011,Social Work,Social Work,22,4,18
2011,Social Work,Social Work,25,0,25
2011,Social Work,Social Work,17,1,16
2011,Social Work,Social Work,58,4,54
2011,Social Work,Social Work,40,6,34
2011,Social Work,Social Work,78,19,59
2011,Social Work,Social Work,107,11,96
2010,Social Work,Social Work,4,1,3
2010,Social Work,Social Work,18,0,18
2010,Social Work,Social Work,14,2,12
2010,Social Work,Social Work,30,3,27
2010,Social Work,Social Work,55,8,47
2010,Social Work,Social Work,32,2,30
2010,Social Work,Social Work,55,5,50
2010,Social Work,Social Work,47,6,41
2010,Social Work,Social Work,52,7,45
2009,Social Work,Social Work,2,0,2
2009,Social Work,Social Work,225,25,200
2009,Social Work,Social Work,33,6,27
2008,Social Work,Social Work,2,0,2
2008,Social Work,Social Work,232,26,206
2008,Social Work,Social Work,29,5,24
2007,Social Work,Social Work,1,0,1
2007,Social Work,Social Work,1,0,1
2007,Social Work,Social Work,228,21,207
2007,Social Work,Social Work,25,5,20
2006,Social Work,Social Work,1,0,1
2006,Social Work,Social Work,229,13,216
2006,Social Work,Social Work,24,4,20
2005,Social Work,Social Work,2,0,2
2005,Social Work,Social Work,3,0,3
2005,Social Work,Social Work,24,3,21
2005,Social Work,Social Work,260,16,244
2004,Social Work,Social Work,274,26,248
2004,Social Work,Social Work,23,4,19
1980,Social Work,Social Work,108,22,86
1980,Social Work,Social Work,207,47,160
1981,Social Work,Social Work,95,16,79
1981,Social Work,Social Work,221,41,180
1982,Social Work,Social Work,83,12,71
1982,Social Work,Social Work,210,52,158
1983,Social Work,Social Work,73,11,62
1983,Social Work,Social Work,200,46,154
1984,Social Work,Social Work,77,10,67
1984,Social Work,Social Work,201,42,159
1985,Social Work,Social Work,83,12,71
1985,Social Work,Social Work,199,43,156
1986,Social Work,Social Work,89,14,75
1986,Social Work,Social Work,181,40,141
1987,Social Work,Social Work,70,12,58
1987,Social Work,Social Work,204,43,161
1988,Social Work,Social Work,174,38,136
1989,Social Work,Social Work,61,7,54
1989,Social Work,Social Work,172,33,139
1990,Social Work,Social Work,68,12,56
1990,Social Work,Social Work,224,36,188
1991,Social Work,Social Work,83,17,66
1991,Social Work,Social Work,243,40,203
1992,Social Work,Social Work,79,10,69
1992,Social Work,Social Work,256,45,211
1993,Social Work,Social Work,50,7,43
1993,Social Work,Social Work,284,49,235
1994,Social Work,Social Work,49,6,43
1994,Social Work,Social Work,283,46,237
1995,Social Work,Social Work,25,4,21
1995,Social Work,Social Work,269,47,222
1996,Social Work,Social Work,275,41,234
1997,Social Work,Social Work,137,20,117
1998,Social Work,Social Work,67,15,52
1999,Social Work,Social Work,11,2,9
2001,Social Work,Social Work,4,1,3
2002,Social Work,Social Work,7,3,4
1997,Social Work,Social Work,6,1,5
1998,Social Work,Social Work,6,2,4
2003,Social Work,Social Work,3,1,2
1997,Social Work,Social Work,14,4,10
1998,Social Work,Social Work,9,1,8
1999,Social Work,Social Work,34,7,27
2000,Social Work,Social Work,44,9,35
2001,Social Work,Social Work,43,8,35
2002,Social Work,Social Work,44,5,39
2003,Social Work,Social Work,51,5,46
1997,Social Work,Social Work,8,3,5
1998,Social Work,Social Work,15,4,11
1999,Social Work,Social Work,18,5,13
2000,Social Work,Social Work,19,5,14
2001,Social Work,Social Work,20,5,15
2002,Social Work,Social Work,17,4,13
2003,Social Work,Social Work,22,3,19
1997,Social Work,Social Work,89,10,79
1998,Social Work,Social Work,192,25,167
1999,Social Work,Social Work,224,31,193
2000,Social Work,Social Work,205,24,181
2001,Social Work,Social Work,179,25,154
2002,Social Work,Social Work,217,29,188
2003,Social Work,Social Work,220,23,197
2018,LAS,Sociology,167,61,106
2018,LAS,Sociology,12,1,11
2018,LAS,Sociology,34,15,19
2017,LAS,Sociology,150,60,90
2017,LAS,Sociology,13,5,8
2017,LAS,Sociology,37,16,21
2016,LAS,Sociology,150,68,82
2016,LAS,Sociology,16,7,9
2016,LAS,Sociology,45,17,28
2015,LAS,Sociology,1,0,1
2015,LAS,Sociology,19,6,13
2015,LAS,Sociology,172,82,90
2015,LAS,Sociology,49,19,30
2014,LAS,Sociology,17,5,12
2014,LAS,Sociology,37,11,26
2014,LAS,Sociology,183,77,106
2013,LAS,Sociology,48,18,30
2013,LAS,Sociology,26,11,15
2013,LAS,Sociology,207,83,124
2012,LAS,Sociology,22,5,17
2012,LAS,Sociology,1,1,0
2012,LAS,Sociology,41,18,23
2012,LAS,Sociology,218,82,136
2011,LAS,Sociology,1,0,1
2011,LAS,Sociology,1,1,0
2011,LAS,Sociology,23,9,14
2011,LAS,Sociology,46,17,29
2011,LAS,Sociology,257,102,155
2010,LAS,Sociology,1,0,1
2010,LAS,Sociology,1,0,1
2010,LAS,Sociology,15,6,9
2010,LAS,Sociology,52,21,31
2010,LAS,Sociology,342,135,207
2009,LAS,Sociology,1,0,1
2009,LAS,Sociology,1,1,0
2009,LAS,Sociology,8,2,6
2009,LAS,Sociology,434,168,265
2009,LAS,Sociology,49,20,29
2008,LAS,Sociology,1,0,1
2008,LAS,Sociology,2,0,2
2008,LAS,Sociology,3,2,1
2008,LAS,Sociology,468,189,277
2008,LAS,Sociology,40,19,21
2007,LAS,Sociology,3,1,2
2007,LAS,Sociology,3,1,2
2007,LAS,Sociology,1,1,0
2007,LAS,Sociology,485,195,289
2007,LAS,Sociology,45,19,26
2006,LAS,Sociology,2,1,1
2006,LAS,Sociology,3,1,2
2006,LAS,Sociology,459,162,296
2006,LAS,Sociology,45,21,24
2005,LAS,Sociology,10,1,9
2005,LAS,Sociology,419,138,281
2005,LAS,Sociology,43,17,26
2004,LAS,Sociology,300,97,203
2004,LAS,Sociology,1,0,1
2004,LAS,Sociology,40,17,23
1980,LAS,Sociology,46,28,18
1981,LAS,Sociology,41,23,18
1982,LAS,Sociology,44,24,20
1983,LAS,Sociology,44,23,21
1984,LAS,Sociology,39,23,16
1985,LAS,Sociology,33,18,15
1986,LAS,Sociology,38,17,21
1987,LAS,Sociology,35,15,20
1988,LAS,Sociology,35,14,21
1989,LAS,Sociology,39,15,24
1990,LAS,Sociology,45,16,29
1991,LAS,Sociology,48,21,27
1992,LAS,Sociology,49,19,30
1993,LAS,Sociology,48,17,31
1994,LAS,Sociology,50,20,30
1995,LAS,Sociology,50,17,33
1996,LAS,Sociology,43,11,32
1997,LAS,Sociology,42,13,29
1998,LAS,Sociology,40,14,26
1999,LAS,Sociology,45,18,27
2000,LAS,Sociology,47,21,26
2001,LAS,Sociology,48,20,28
2002,LAS,Sociology,47,22,25
2003,LAS,Sociology,47,23,24
1983,ACES,SOIL SCI,2,1,1
1990,ACES,SOIL SCI,7,6,1
1991,ACES,SOIL SCI,5,4,1
1992,ACES,SOIL SCI,6,4,2
2018,LAS,Spanish,69,24,45
2018,LAS,Spanish,8,3,5
2018,LAS,Spanish,1,1,0
2018,LAS,Spanish,1,0,1
2018,LAS,Spanish,5,3,2
2018,LAS,Spanish,33,8,25
2018,LAS,Spanish,1,1,0
2018,LAS,Spanish,3,0,3
2017,LAS,Spanish,79,24,55
2017,LAS,Spanish,10,2,8
2017,LAS,Spanish,8,1,7
2017,LAS,Spanish,6,2,4
2017,LAS,Spanish,28,6,22
2017,LAS,Spanish,1,1,0
2017,LAS,Spanish,3,0,3
2016,LAS,Spanish,82,22,60
2016,LAS,Spanish,8,2,6
2016,LAS,Spanish,12,1,11
2016,LAS,Spanish,8,3,5
2016,LAS,Spanish,25,5,20
2016,LAS,Spanish,1,1,0
2016,LAS,Spanish,1,0,1
2015,LAS,Spanish,6,2,4
2015,LAS,Spanish,1,0,1
2015,LAS,Spanish,70,15,55
2015,LAS,Spanish,3,3,0
2015,LAS,Spanish,7,0,7
2015,LAS,Spanish,11,1,10
2015,LAS,Spanish,23,6,17
2014,LAS,Spanish,1,1,0
2014,LAS,Spanish,1,1,0
2014,LAS,Spanish,77,15,62
2014,LAS,Spanish,11,4,7
2014,LAS,Spanish,5,2,3
2014,LAS,Spanish,6,0,6
2014,LAS,Spanish,7,1,6
2014,LAS,Spanish,29,7,22
2013,LAS,Spanish,22,5,17
2013,LAS,Spanish,8,2,6
2013,LAS,Spanish,21,7,14
2013,LAS,Spanish,17,5,12
2013,LAS,Spanish,125,30,95
2012,LAS,Spanish,12,5,7
2012,LAS,Spanish,4,1,3
2012,LAS,Spanish,23,3,20
2012,LAS,Spanish,25,7,18
2012,LAS,Spanish,124,31,93
2011,LAS,Spanish,5,2,3
2011,LAS,Spanish,2,1,1
2011,LAS,Spanish,27,1,26
2011,LAS,Spanish,29,6,23
2011,LAS,Spanish,141,40,101
2010,LAS,Spanish,18,2,16
2010,LAS,Spanish,1,1,0
2010,LAS,Spanish,8,2,6
2010,LAS,Spanish,28,5,23
2010,LAS,Spanish,171,39,132
2009,LAS,Spanish,20,5,15
2009,LAS,Spanish,2,1,1
2009,LAS,Spanish,207,55,152
2009,LAS,Spanish,11,4,7
2009,LAS,Spanish,8,2,6
2009,LAS,Spanish,29,4,25
2008,LAS,Spanish,12,4,8
2008,LAS,Spanish,237,64,173
2008,LAS,Spanish,16,5,11
2008,LAS,Spanish,33,5,28
2007,LAS,Spanish,1,0,1
2007,LAS,Spanish,8,4,4
2007,LAS,Spanish,286,73,213
2007,LAS,Spanish,17,4,13
2007,LAS,Spanish,41,11,30
2006,LAS,Spanish,5,2,3
2006,LAS,Spanish,310,79,231
2006,LAS,Spanish,21,6,15
2006,LAS,Spanish,38,13,25
2005,LAS,Spanish,8,3,5
2005,LAS,Spanish,259,79,180
2005,LAS,Spanish,21,5,16
2005,LAS,Spanish,30,10,20
2004,LAS,Spanish,241,70,170
2004,LAS,Spanish,1,0,1
2004,LAS,Spanish,22,9,13
2004,LAS,Spanish,1,0,1
2004,LAS,Spanish,29,13,16
1980,Education,Special Education,82,16,66
1981,Education,Special Education,98,16,82
1982,Education,Special Education,78,12,66
1983,Education,Special Education,60,9,51
1984,Education,Special Education,47,11,36
1985,Education,Special Education,51,6,45
1986,Education,Special Education,54,9,45
1987,Education,Special Education,52,8,44
1988,Education,Special Education,47,9,38
1989,Education,Special Education,59,7,52
1990,Education,Special Education,65,15,50
1991,Education,Special Education,78,12,66
1992,Education,Special Education,78,9,69
1993,Education,Special Education,98,10,88
1994,Education,Special Education,112,17,95
1995,Education,Special Education,105,13,92
1996,Education,Special Education,93,11,82
1997,Education,Special Education,84,10,74
1998,Education,Special Education,84,11,73
1999,Education,Special Education,77,10,67
2000,Education,Special Education,92,9,83
2001,Education,Special Education,97,14,83
2002,Education,Special Education,89,11,78
2003,Education,Special Education,75,10,65
1980,Education,Special Education,23,2,21
1981,Education,Special Education,30,2,28
1982,Education,Special Education,28,3,25
1983,Education,Special Education,30,2,28
1984,Education,Special Education,21,2,19
1985,Education,Special Education,19,3,16
1986,Education,Special Education,19,2,17
1987,Education,Special Education,22,2,20
1988,Education,Special Education,24,1,23
1989,Education,Special Education,15,1,14
1996,Education,Special Education,17,3,14
1997,Education,Special Education,13,1,12
1999,Education,Special Education,19,1,18
2000,Education,Special Education,29,3,26
2001,Education,Special Education,33,1,32
2002,Education,Special Education,42,4,38
2003,Education,Special Education,59,6,53
2018,Education,Special Education,107,14,92
2018,Education,Special Education,11,1,10
2018,Education,Special Education,15,0,15
2018,Education,Special Education,1,0,1
2018,Education,Special Education,26,4,22
2017,Education,Special Education,119,14,105
2017,Education,Special Education,20,3,17
2017,Education,Special Education,10,0,10
2017,Education,Special Education,2,0,2
2017,Education,Special Education,24,4,20
2016,Education,Special Education,121,13,108
2016,Education,Special Education,20,3,17
2016,Education,Special Education,6,2,4
2016,Education,Special Education,27,3,24
2015,Education,Special Education,5,2,3
2015,Education,Special Education,125,10,115
2015,Education,Special Education,19,2,17
2015,Education,Special Education,23,3,20
2014,Education,Special Education,3,1,2
2014,Education,Special Education,1,0,1
2014,Education,Special Education,89,11,78
2014,Education,Special Education,28,4,24
2014,Education,Special Education,23,3,20
2013,Education,Special Education,3,0,3
2013,Education,Special Education,1,1,0
2013,Education,Special Education,1,1,0
2013,Education,Special Education,82,6,76
2013,Education,Special Education,27,3,24
2013,Education,Special Education,22,3,19
2012,Education,Special Education,1,1,0
2012,Education,Special Education,3,1,2
2012,Education,Special Education,5,2,3
2012,Education,Special Education,80,7,73
2012,Education,Special Education,24,2,22
2012,Education,Special Education,34,4,30
2011,Education,Special Education,76,9,67
2011,Education,Special Education,1,1,0
2011,Education,Special Education,1,0,1
2011,Education,Special Education,31,5,26
2011,Education,Special Education,23,1,22
2010,Education,Special Education,1,0,1
2010,Education,Special Education,1,0,1
2010,Education,Special Education,76,8,68
2010,Education,Special Education,36,7,29
2010,Education,Special Education,26,2,24
2009,Education,Special Education,7,1,6
2009,Education,Special Education,2,1,1
2009,Education,Special Education,3,0,3
2009,Education,Special Education,67,9,58
2009,Education,Special Education,36,6,30
2009,Education,Special Education,26,5,21
2008,Education,Special Education,1,0,1
2008,Education,Special Education,8,1,7
2008,Education,Special Education,1,0,1
2008,Education,Special Education,3,0,2
2008,Education,Special Education,67,8,59
2008,Education,Special Education,31,5,26
2008,Education,Special Education,22,6,16
2007,Education,Special Education,1,1,0
2007,Education,Special Education,69,8,61
2007,Education,Special Education,7,0,7
2007,Education,Special Education,3,0,3
2007,Education,Special Education,34,4,30
2007,Education,Special Education,29,8,21
2006,Education,Special Education,1,1,0
2006,Education,Special Education,69,6,63
2006,Education,Special Education,6,0,6
2006,Education,Special Education,14,3,11
2006,Education,Special Education,32,0,32
2006,Education,Special Education,32,7,25
2005,Education,Special Education,1,0,1
2005,Education,Special Education,76,4,72
2005,Education,Special Education,6,0,6
2005,Education,Special Education,11,2,9
2005,Education,Special Education,32,1,31
2005,Education,Special Education,31,8,23
2004,Education,Special Education,71,5,66
2004,Education,Special Education,2,0,2
2004,Education,Special Education,25,6,19
2004,Education,Special Education,44,4,40
2004,Education,Special Education,1,0,1
2004,Education,Special Education,7,1,6
2018,Applied Health Sciences,Speech & Hearing Science,62,3,59
2018,Applied Health Sciences,Speech & Hearing Science,14,0,14
2018,Applied Health Sciences,Speech & Hearing Science,11,3,8
2018,Applied Health Sciences,Speech & Hearing Science,146,3,143
2018,Applied Health Sciences,Speech & Hearing Science,9,1,8
2018,Applied Health Sciences,Speech & Hearing Science,47,3,44
2018,Applied Health Sciences,Speech & Hearing Science,9,1,8
2017,Applied Health Sciences,Speech & Hearing Science,68,4,64
2017,Applied Health Sciences,Speech & Hearing Science,15,1,14
2017,Applied Health Sciences,Speech & Hearing Science,9,3,6
2017,Applied Health Sciences,Speech & Hearing Science,152,4,148
2017,Applied Health Sciences,Speech & Hearing Science,11,3,8
2017,Applied Health Sciences,Speech & Hearing Science,47,1,46
2017,Applied Health Sciences,Speech & Hearing Science,10,1,9
2016,Applied Health Sciences,Speech & Hearing Science,72,7,65
2016,Applied Health Sciences,Speech & Hearing Science,8,2,6
2016,Applied Health Sciences,Speech & Hearing Science,12,1,11
2016,Applied Health Sciences,Speech & Hearing Science,178,8,170
2016,Applied Health Sciences,Speech & Hearing Science,8,2,6
2016,Applied Health Sciences,Speech & Hearing Science,52,2,50
2016,Applied Health Sciences,Speech & Hearing Science,13,1,12
2015,Applied Health Sciences,Speech & Hearing Science,5,2,3
2015,Applied Health Sciences,Speech & Hearing Science,13,1,12
2015,Applied Health Sciences,Speech & Hearing Science,3,0,3
2015,Applied Health Sciences,Speech & Hearing Science,206,6,200
2015,Applied Health Sciences,Speech & Hearing Science,59,4,55
2015,Applied Health Sciences,Speech & Hearing Science,11,2,9
2015,Applied Health Sciences,Speech & Hearing Science,53,1,52
2014,Applied Health Sciences,Speech & Hearing Science,1,0,1
2014,Applied Health Sciences,Speech & Hearing Science,64,3,61
2014,Applied Health Sciences,Speech & Hearing Science,19,1,18
2014,Applied Health Sciences,Speech & Hearing Science,190,2,188
2014,Applied Health Sciences,Speech & Hearing Science,11,1,10
2014,Applied Health Sciences,Speech & Hearing Science,57,4,53
2013,Applied Health Sciences,Speech & Hearing Science,2,0,2
2013,Applied Health Sciences,Speech & Hearing Science,15,2,13
2013,Applied Health Sciences,Speech & Hearing Science,49,2,47
2013,Applied Health Sciences,Speech & Hearing Science,56,6,50
2013,Applied Health Sciences,Speech & Hearing Science,8,0,8
2013,Applied Health Sciences,Speech & Hearing Science,233,5,228
2012,Applied Health Sciences,Speech & Hearing Science,1,0,1
2012,Applied Health Sciences,Speech & Hearing Science,46,1,45
2012,Applied Health Sciences,Speech & Hearing Science,7,0,7
2012,Applied Health Sciences,Speech & Hearing Science,17,1,16
2012,Applied Health Sciences,Speech & Hearing Science,43,3,40
2012,Applied Health Sciences,Speech & Hearing Science,1,0,1
2012,Applied Health Sciences,Speech & Hearing Science,9,1,8
2012,Applied Health Sciences,Speech & Hearing Science,257,6,251
2011,Applied Health Sciences,Speech & Hearing Science,2,0,2
2011,Applied Health Sciences,Speech & Hearing Science,11,1,10
2011,Applied Health Sciences,Speech & Hearing Science,55,2,53
2011,Applied Health Sciences,Speech & Hearing Science,7,1,6
2011,Applied Health Sciences,Speech & Hearing Science,118,4,114
2011,Applied Health Sciences,Speech & Hearing Science,169,7,162
2010,Applied Health Sciences,Speech & Hearing Science,80,1,79
2010,Applied Health Sciences,Speech & Hearing Science,11,2,9
2010,Applied Health Sciences,Speech & Hearing Science,55,2,53
2010,Applied Health Sciences,Speech & Hearing Science,6,1,5
2010,Applied Health Sciences,Speech & Hearing Science,6,0,6
2010,Applied Health Sciences,Speech & Hearing Science,178,8,170
2009,Applied Health Sciences,Speech & Hearing Science,3,0,3
2009,Applied Health Sciences,Speech & Hearing Science,11,1,10
2009,Applied Health Sciences,Speech & Hearing Science,71,3,67
2009,Applied Health Sciences,Speech & Hearing Science,188,9,179
2009,Applied Health Sciences,Speech & Hearing Science,51,2,49
2009,Applied Health Sciences,Speech & Hearing Science,16,2,14
2008,Applied Health Sciences,Speech & Hearing Science,3,0,3
2008,Applied Health Sciences,Speech & Hearing Science,6,1,5
2008,Applied Health Sciences,Speech & Hearing Science,128,6,122
2008,Applied Health Sciences,Speech & Hearing Science,141,10,131
2008,Applied Health Sciences,Speech & Hearing Science,50,1,49
2008,Applied Health Sciences,Speech & Hearing Science,21,2,19
2007,Applied Health Sciences,Speech & Hearing Science,90,5,85
2007,Applied Health Sciences,Speech & Hearing Science,1,0,1
2007,Applied Health Sciences,Speech & Hearing Science,9,1,8
2007,Applied Health Sciences,Speech & Hearing Science,174,7,167
2007,Applied Health Sciences,Speech & Hearing Science,43,1,42
2007,Applied Health Sciences,Speech & Hearing Science,25,1,24
2006,Applied Health Sciences,Speech & Hearing Science,51,1,50
2006,Applied Health Sciences,Speech & Hearing Science,2,0,2
2006,Applied Health Sciences,Speech & Hearing Science,16,2,14
2006,Applied Health Sciences,Speech & Hearing Science,183,5,177
2006,Applied Health Sciences,Speech & Hearing Science,39,1,38
2006,Applied Health Sciences,Speech & Hearing Science,22,1,21
2005,Applied Health Sciences,Speech & Hearing Science,7,0,7
2005,Applied Health Sciences,Speech & Hearing Science,21,2,19
2005,Applied Health Sciences,Speech & Hearing Science,59,6,53
2005,Applied Health Sciences,Speech & Hearing Science,142,1,141
2005,Applied Health Sciences,Speech & Hearing Science,46,2,44
2005,Applied Health Sciences,Speech & Hearing Science,23,2,21
2004,Applied Health Sciences,Speech & Hearing Science,224,8,216
2004,Applied Health Sciences,Speech & Hearing Science,43,3,40
2004,Applied Health Sciences,Speech & Hearing Science,24,2,22
2017,LAS,Speech Communication,3,2,1
2016,LAS,Speech Communication,1,0,1
2015,LAS,Speech Communication,1,1,0
2015,LAS,Speech Communication,1,1,0
2014,LAS,Speech Communication,1,0,1
2014,LAS,Speech Communication,1,1,0
2013,LAS,Speech Communication,2,2,0
2012,LAS,Speech Communication,1,1,0
2012,LAS,Speech Communication,5,5,0
2011,LAS,Speech Communication,4,4,0
2011,LAS,Speech Communication,9,2,7
2010,LAS,Speech Communication,7,0,7
2010,LAS,Speech Communication,8,7,1
2010,LAS,Speech Communication,64,21,43
2009,LAS,Speech Communication,11,2,9
2009,LAS,Speech Communication,5,2,3
2009,LAS,Speech Communication,13,8,5
2009,LAS,Speech Communication,348,144,204
2008,LAS,Speech Communication,4,1,3
2008,LAS,Speech Communication,22,10,12
2008,LAS,Speech Communication,39,13,26
2008,LAS,Speech Communication,697,295,402
2007,LAS,Speech Communication,4,0,4
2007,LAS,Speech Communication,18,8,10
2007,LAS,Speech Communication,41,15,26
2007,LAS,Speech Communication,666,295,370
2006,LAS,Speech Communication,3,0,3
2006,LAS,Speech Communication,25,7,18
2006,LAS,Speech Communication,41,15,26
2006,LAS,Speech Communication,523,233,290
2005,LAS,Speech Communication,9,2,7
2005,LAS,Speech Communication,1,1,0
2005,LAS,Speech Communication,1,1,0
2005,LAS,Speech Communication,38,11,27
2005,LAS,Speech Communication,416,177,239
2005,LAS,Speech Communication,39,15,24
2004,LAS,Speech Communication,400,177,223
2004,LAS,Speech Communication,2,1,1
2004,LAS,Speech Communication,32,8,24
2004,LAS,Speech Communication,29,13,16
1980,LAS,Speech Communication,49,27,22
1981,LAS,Speech Communication,60,31,29
1982,LAS,Speech Communication,62,33,29
1983,LAS,Speech Communication,47,23,24
1984,LAS,Speech Communication,48,21,27
1985,LAS,Speech Communication,49,21,28
1986,LAS,Speech Communication,39,19,20
1987,LAS,Speech Communication,46,20,26
1988,LAS,Speech Communication,55,22,33
1989,LAS,Speech Communication,49,18,31
1990,LAS,Speech Communication,53,21,32
1991,LAS,Speech Communication,57,24,33
1992,LAS,Speech Communication,59,27,32
1993,LAS,Speech Communication,59,23,36
1994,LAS,Speech Communication,61,27,34
1995,LAS,Speech Communication,63,27,36
1996,LAS,Speech Communication,53,23,30
1997,LAS,Speech Communication,58,23,35
1998,LAS,Speech Communication,61,23,38
1999,LAS,Speech Communication,50,20,30
2000,LAS,Speech Communication,51,20,31
2001,LAS,Speech Communication,44,20,24
2002,LAS,Speech Communication,54,23,31
2003,LAS,Speech Communication,54,19,35
2018,LAS,Statistics,312,194,118
2018,LAS,Statistics,63,34,29
2018,LAS,Statistics,82,34,48
2018,LAS,Statistics,1,0,1
2018,LAS,Statistics,54,28,26
2018,LAS,Statistics,49,35,14
2017,LAS,Statistics,261,164,97
2017,LAS,Statistics,57,30,27
2017,LAS,Statistics,87,38,49
2017,LAS,Statistics,4,1,3
2017,LAS,Statistics,59,25,34
2017,LAS,Statistics,38,28,10
2016,LAS,Statistics,185,111,74
2016,LAS,Statistics,57,29,28
2016,LAS,Statistics,82,37,45
2016,LAS,Statistics,3,1,2
2016,LAS,Statistics,50,22,28
2016,LAS,Statistics,41,28,13
2015,LAS,Statistics,5,2,3
2015,LAS,Statistics,45,26,19
2015,LAS,Statistics,45,22,23
2015,LAS,Statistics,42,29,13
2015,LAS,Statistics,54,22,32
2015,LAS,Statistics,145,92,53
2014,LAS,Statistics,3,0,3
2014,LAS,Statistics,16,9,7
2014,LAS,Statistics,26,10,16
2014,LAS,Statistics,33,23,10
2014,LAS,Statistics,58,28,30
2014,LAS,Statistics,126,84,42
2013,LAS,Statistics,1,0,1
2013,LAS,Statistics,1,1,0
2013,LAS,Statistics,17,9,8
2013,LAS,Statistics,4,2,2
2013,LAS,Statistics,15,6,9
2013,LAS,Statistics,8,4,4
2013,LAS,Statistics,8,4,4
2013,LAS,Statistics,47,26,21
2013,LAS,Statistics,34,22,12
2013,LAS,Statistics,125,94,31
2012,LAS,Statistics,11,4,7
2012,LAS,Statistics,4,2,2
2012,LAS,Statistics,11,5,6
2012,LAS,Statistics,71,34,37
2012,LAS,Statistics,30,20,10
2012,LAS,Statistics,143,103,40
2011,LAS,Statistics,1,1,0
2011,LAS,Statistics,13,7,6
2011,LAS,Statistics,41,16,25
2011,LAS,Statistics,1,1,0
2011,LAS,Statistics,13,6,7
2011,LAS,Statistics,28,19,9
2011,LAS,Statistics,123,76,47
2010,LAS,Statistics,3,2,1
2010,LAS,Statistics,25,10,15
2010,LAS,Statistics,1,1,0
2010,LAS,Statistics,9,4,5
2010,LAS,Statistics,27,16,11
2010,LAS,Statistics,112,72,40
2009,LAS,Statistics,2,1,1
2009,LAS,Statistics,5,4,1
2009,LAS,Statistics,25,9,16
2009,LAS,Statistics,94,59,35
2009,LAS,Statistics,29,15,14
2008,LAS,Statistics,3,1,2
2008,LAS,Statistics,27,12,15
2008,LAS,Statistics,74,47,27
2008,LAS,Statistics,29,17,12
2007,LAS,Statistics,2,2,0
2007,LAS,Statistics,1,0,1
2007,LAS,Statistics,3,1,2
2007,LAS,Statistics,59,42,17
2007,LAS,Statistics,26,10,16
2007,LAS,Statistics,27,15,12
2006,LAS,Statistics,1,1,0
2006,LAS,Statistics,36,22,14
2006,LAS,Statistics,18,9,9
2006,LAS,Statistics,20,11,9
2005,LAS,Statistics,1,1,0
2005,LAS,Statistics,1,0,1
2005,LAS,Statistics,1,0,1
2005,LAS,Statistics,36,27,9
2005,LAS,Statistics,22,9,13
2005,LAS,Statistics,16,7,9
2004,LAS,Statistics,29,22,7
2004,LAS,Statistics,9,3,6
2004,LAS,Statistics,6,3,3
2004,LAS,Statistics,4,1,3
2004,LAS,Statistics,16,6,10
2018,LAS,Statistics & Computer Science,242,180,62
2018,LAS,Statistics & Computer Science,17,15,2
2017,LAS,Statistics & Computer Science,190,140,50
2017,LAS,Statistics & Computer Science,13,10,3
2016,LAS,Statistics & Computer Science,135,97,38
2016,LAS,Statistics & Computer Science,7,6,1
2015,LAS,Statistics & Computer Science,7,5,2
2015,LAS,Statistics & Computer Science,100,81,19
2014,LAS,Statistics & Computer Science,2,1,1
2014,LAS,Statistics & Computer Science,53,45,8
2013,LAS,Statistics & Computer Science,34,26,8
2012,LAS,Statistics & Computer Science,20,14,6
2011,LAS,Statistics & Computer Science,1,0,1
2011,LAS,Statistics & Computer Science,15,11,4
2010,LAS,Statistics & Computer Science,2,0,2
2010,LAS,Statistics & Computer Science,17,12,5
2009,LAS,Statistics & Computer Science,16,13,3
2008,LAS,Statistics & Computer Science,14,11,3
2007,LAS,Statistics & Computer Science,8,6,2
2006,LAS,Statistics & Computer Science,11,9,2
2005,LAS,Statistics & Computer Science,10,9,1
2004,LAS,Statistics & Computer Science,15,12,3
2018,Media,Strategic Brand Communication,67,17,50
2018,Media,Strategic Brand Communication,1,0,1
2017,Media,Strategic Brand Communication,23,5,18
2018,Business,Supply Chain Management,15,7,8
2018,Business,Supply Chain Management,70,25,45
2017,Business,Supply Chain Management,14,6,8
2017,Business,Supply Chain Management,65,23,42
2016,Business,Supply Chain Management,17,4,13
2016,Business,Supply Chain Management,68,24,44
2015,Business,Supply Chain Management,13,6,7
2015,Business,Supply Chain Management,79,32,47
2014,Business,Supply Chain Management,14,9,5
2014,Business,Supply Chain Management,76,41,35
2013,Business,Supply Chain Management,16,8,8
2013,Business,Supply Chain Management,54,30,24
2012,Business,Supply Chain Management,15,8,7
2012,Business,Supply Chain Management,43,25,18
2011,Business,Supply Chain Management,20,10,10
2011,Business,Supply Chain Management,30,17,13
2010,Business,Supply Chain Management,27,17,10
2010,Business,Supply Chain Management,25,15,10
2009,Business,Supply Chain Management,28,17,11
2009,Business,Supply Chain Management,7,7,0
2008,Business,Supply Chain Management,2,2,0
2008,Business,Supply Chain Management,22,14,8
2003,Engineering,Systems & Entrepreneurial Engr,12,10,2
2018,Engineering,Systems & Entrepreneurial Engr,4,4,0
2018,Engineering,Systems & Entrepreneurial Engr,18,18,0
2017,Engineering,Systems & Entrepreneurial Engr,7,5,2
2017,Engineering,Systems & Entrepreneurial Engr,17,16,1
2016,Engineering,Systems & Entrepreneurial Engr,5,3,2
2016,Engineering,Systems & Entrepreneurial Engr,15,14,1
2015,Engineering,Systems & Entrepreneurial Engr,8,4,4
2015,Engineering,Systems & Entrepreneurial Engr,20,17,3
2014,Engineering,Systems & Entrepreneurial Engr,8,8,0
2014,Engineering,Systems & Entrepreneurial Engr,16,13,3
2013,Engineering,Systems & Entrepreneurial Engr,11,6,5
2013,Engineering,Systems & Entrepreneurial Engr,14,10,4
2012,Engineering,Systems & Entrepreneurial Engr,8,4,4
2012,Engineering,Systems & Entrepreneurial Engr,12,10,2
2011,Engineering,Systems & Entrepreneurial Engr,6,3,3
2011,Engineering,Systems & Entrepreneurial Engr,13,10,3
2010,Engineering,Systems & Entrepreneurial Engr,8,7,1
2010,Engineering,Systems & Entrepreneurial Engr,18,14,4
2009,Engineering,Systems & Entrepreneurial Engr,11,7,4
2009,Engineering,Systems & Entrepreneurial Engr,19,15,4
2008,Engineering,Systems & Entrepreneurial Engr,9,6,3
2008,Engineering,Systems & Entrepreneurial Engr,24,22,2
2007,Engineering,Systems & Entrepreneurial Engr,7,5,2
2007,Engineering,Systems & Entrepreneurial Engr,26,25,1
2006,Engineering,Systems & Entrepreneurial Engr,7,6,1
2006,Engineering,Systems & Entrepreneurial Engr,24,23,1
2005,Engineering,Systems & Entrepreneurial Engr,4,2,2
2005,Engineering,Systems & Entrepreneurial Engr,23,22,1
2004,Engineering,Systems & Entrepreneurial Engr,2,1,1
2004,Engineering,Systems & Entrepreneurial Engr,21,19,2
2018,Engineering,Systems Engineering and Design,249,180,68
2017,Engineering,Systems Engineering and Design,228,176,52
2016,Engineering,Systems Engineering and Design,4,4,0
2017,Business,Taxation,26,13,13
2016,Business,Taxation,24,9,15
2015,Business,Taxation,24,7,17
2014,Business,Taxation,28,15,13
2013,Business,Taxation,31,13,18
2012,Business,Taxation,31,8,23
2011,Business,Taxation,21,6,15
2010,Business,Taxation,29,16,13
2009,Business,Taxation,26,12,14
1980,LAS,TCH BIOL,17,6,11
1981,LAS,TCH BIOL,17,8,9
1982,LAS,TCH BIOL,10,3,7
1983,LAS,TCH BIOL,20,6,14
1984,LAS,TCH BIOL,27,5,22
1985,LAS,TCH BIOL,23,6,17
1986,LAS,TCH BIOL,28,6,22
1987,LAS,TCH BIOL,22,4,18
1988,LAS,TCH BIOL,26,9,17
1989,LAS,TCH BIOL,19,7,12
1990,LAS,TCH BIOL,18,6,12
1991,LAS,TCH BIOL,29,9,20
1992,LAS,TCH BIOL,27,9,18
1993,LAS,TCH BIOL,28,7,21
1994,LAS,TCH BIOL,20,4,16
1995,LAS,TCH BIOL,21,7,14
1996,LAS,TCH BIOL,20,7,13
1997,LAS,TCH BIOL,24,9,15
1998,LAS,TCH BIOL,12,5,7
1999,LAS,TCH BIOL,5,2,3
1982,Engineering,TCH CS,9,5,4
1983,Engineering,TCH CS,4,2,2
1984,Engineering,TCH CS,3,2,1
1986,Engineering,TCH CS,2,1,1
1992,Engineering,TCH CS,2,1,1
1995,Engineering,TCH CS,2,1,1
1980,Education,TCH ENGL,12,3,9
1981,Education,TCH ENGL,15,1,14
1982,Education,TCH ENGL,21,3,18
1983,Education,TCH ENGL,21,6,15
1984,Education,TCH ENGL,24,6,18
1985,Education,TCH ENGL,24,6,18
1986,Education,TCH ENGL,33,10,23
1987,Education,TCH ENGL,39,10,29
1988,Education,TCH ENGL,43,13,30
1989,Education,TCH ENGL,38,6,32
1990,Education,TCH ENGL,47,11,36
1991,Education,TCH ENGL,53,14,39
1992,Education,TCH ENGL,56,13,43
1993,Education,TCH ENGL,64,12,52
1980,LAS,TCH ENGL,4,2,2
1980,LAS,TCH ENGL,51,6,45
1981,LAS,TCH ENGL,6,1,5
1981,LAS,TCH ENGL,39,7,32
1982,LAS,TCH ENGL,5,1,4
1982,LAS,TCH ENGL,35,11,24
1983,LAS,TCH ENGL,3,2,1
1983,LAS,TCH ENGL,35,11,24
1984,LAS,TCH ENGL,42,12,30
1985,LAS,TCH ENGL,34,7,27
1986,LAS,TCH ENGL,41,10,31
1987,LAS,TCH ENGL,56,12,44
1988,LAS,TCH ENGL,58,9,49
1989,LAS,TCH ENGL,73,13,60
1990,LAS,TCH ENGL,81,21,60
1991,LAS,TCH ENGL,74,21,53
1992,LAS,TCH ENGL,87,28,59
1993,LAS,TCH ENGL,115,39,76
1994,LAS,TCH ENGL,100,34,66
1995,LAS,TCH ENGL,74,24,50
1996,LAS,TCH ENGL,41,14,27
1997,LAS,TCH ENGL,45,16,29
1998,LAS,TCH ENGL,25,8,17
1999,LAS,TCH ENGL,5,2,3
1994,Education,TCH ENGL IN MN,15,4,11
1995,Education,TCH ENGL IN MN,17,7,10
1996,Education,TCH ENGL IN MN,16,5,11
1997,Education,TCH ENGL IN MN,11,4,7
1998,Education,TCH ENGL IN MN,5,2,3
1994,Education,TCH ENGL OUT MN,52,11,41
1995,Education,TCH ENGL OUT MN,55,16,39
1996,Education,TCH ENGL OUT MN,41,10,31
1997,Education,TCH ENGL OUT MN,37,6,31
1998,Education,TCH ENGL OUT MN,18,3,15
1999,Education,TCH ENGL OUT MN,5,2,3
1981,Education,TCH GEN SCIENCE,3,2,1
1982,Education,TCH GEN SCIENCE,6,3,3
1983,Education,TCH GEN SCIENCE,9,4,5
1984,Education,TCH GEN SCIENCE,7,3,4
1985,Education,TCH GEN SCIENCE,13,5,8
1986,Education,TCH GEN SCIENCE,6,1,5
1987,Education,TCH GEN SCIENCE,11,7,4
1988,Education,TCH GEN SCIENCE,9,3,6
1989,Education,TCH GEN SCIENCE,9,4,5
1990,Education,TCH GEN SCIENCE,11,7,4
1991,Education,TCH GEN SCIENCE,8,5,3
1992,Education,TCH GEN SCIENCE,10,8,2
1993,Education,TCH GEN SCIENCE,5,4,1
1996,Education,TCH GEN SCIENCE,7,2,5
1997,Education,TCH GEN SCIENCE,7,2,5
1998,Education,TCH GEN SCIENCE,4,2,2
1980,Applied Health Sciences,TCH KINES,8,3,5
1981,Applied Health Sciences,TCH KINES,10,4,6
1982,Applied Health Sciences,TCH KINES,7,4,3
1983,Applied Health Sciences,TCH KINES,3,2,1
1980,Education,TCH LIFE SCI,9,5,4
1981,Education,TCH LIFE SCI,9,3,6
1982,Education,TCH LIFE SCI,6,2,4
1983,Education,TCH LIFE SCI,6,2,4
1984,Education,TCH LIFE SCI,16,5,11
1985,Education,TCH LIFE SCI,10,3,7
1986,Education,TCH LIFE SCI,13,5,8
1987,Education,TCH LIFE SCI,11,4,7
1988,Education,TCH LIFE SCI,11,3,8
1989,Education,TCH LIFE SCI,13,6,7
1990,Education,TCH LIFE SCI,10,5,5
1991,Education,TCH LIFE SCI,10,5,5
1992,Education,TCH LIFE SCI,11,3,8
1993,Education,TCH LIFE SCI,9,2,7
1994,Education,TCH LIFE SCI,9,2,7
1995,Education,TCH LIFE SCI,5,2,3
1996,Education,TCH LIFE SCI,4,1,3
1997,Education,TCH LIFE SCI,3,2,1
1980,Education,TCH PHYS SCI,2,1,1
1981,Education,TCH PHYS SCI,2,1,1
1982,Education,TCH PHYS SCI,4,2,2
1984,Education,TCH PHYS SCI,4,2,2
1985,Education,TCH PHYS SCI,5,3,2
1986,Education,TCH PHYS SCI,4,2,2
1987,Education,TCH PHYS SCI,4,3,1
1988,Education,TCH PHYS SCI,7,4,3
1989,Education,TCH PHYS SCI,2,1,1
1991,Education,TCH PHYS SCI,8,6,2
1992,Education,TCH PHYS SCI,5,4,1
1993,Education,TCH PHYS SCI,5,2,3
1994,Education,TCH PS CHEM,3,1,2
1990,LAS,TCH RUSS,2,1,1
1990,LAS,TCH RUSS,3,2,1
1991,LAS,TCH RUSS,3,1,2
1992,LAS,TCH RUSS,2,1,1
1980,Education,TCH SOC ST,32,15,17
1981,Education,TCH SOC ST,26,17,9
1982,Education,TCH SOC ST,23,15,8
1983,Education,TCH SOC ST,33,21,12
1984,Education,TCH SOC ST,36,24,12
1985,Education,TCH SOC ST,37,27,10
1986,Education,TCH SOC ST,39,24,15
1987,Education,TCH SOC ST,39,22,17
1988,Education,TCH SOC ST,54,30,24
1989,Education,TCH SOC ST,51,30,21
1990,Education,TCH SOC ST,55,30,25
1991,Education,TCH SOC ST,55,29,26
1992,Education,TCH SOC ST,58,33,25
1993,Education,TCH SOC ST,64,35,29
1980,LAS,TCH SOC ST,9,5,4
1981,LAS,TCH SOC ST,13,8,5
1982,LAS,TCH SOC ST,7,3,4
1983,LAS,TCH SOC ST,7,4,3
1984,LAS,TCH SOC ST,6,5,1
1985,LAS,TCH SOC ST,10,7,3
1986,LAS,TCH SOC ST,11,8,3
1987,LAS,TCH SOC ST,15,10,5
1988,LAS,TCH SOC ST,20,14,6
1989,LAS,TCH SOC ST,16,8,8
1990,LAS,TCH SOC ST,24,9,15
1991,LAS,TCH SOC ST,40,14,26
1992,LAS,TCH SOC ST,54,21,33
1993,LAS,TCH SOC ST,74,35,39
1994,LAS,TCH SOC ST,47,26,21
1995,LAS,TCH SOC ST,33,20,13
1996,LAS,TCH SOC ST,26,13,13
1997,LAS,TCH SOC ST,23,13,10
1998,LAS,TCH SOC ST,12,9,3
1994,Education,TCH SOC ST IN,32,20,12
1995,Education,TCH SOC ST IN,27,16,11
1996,Education,TCH SOC ST IN,27,20,7
1997,Education,TCH SOC ST IN,26,16,10
1998,Education,TCH SOC ST IN,13,7,6
1994,Education,TCH SOC ST OUT,26,12,14
1995,Education,TCH SOC ST OUT,22,14,8
1996,Education,TCH SOC ST OUT,28,18,10
1997,Education,TCH SOC ST OUT,25,15,10
1998,Education,TCH SOC ST OUT,15,8,7
1980,LAS,TCH SPEECH,9,5,4
1981,LAS,TCH SPEECH,10,3,7
1982,LAS,TCH SPEECH,9,2,7
1983,LAS,TCH SPEECH,8,2,6
1984,LAS,TCH SPEECH,8,1,7
1985,LAS,TCH SPEECH,7,1,6
1986,LAS,TCH SPEECH,8,1,7
1987,LAS,TCH SPEECH,6,2,4
1988,LAS,TCH SPEECH,7,1,6
1989,LAS,TCH SPEECH,8,1,7
1993,LAS,TCH SPEECH,5,1,4
1994,LAS,TCH SPEECH,7,1,6
1985,LAS,TEACH CS,6,5,1
1986,LAS,TEACH CS,6,5,1
1987,LAS,TEACH CS,3,1,2
1988,LAS,TEACH CS,4,3,1
1989,LAS,TEACH CS,4,1,3
1990,LAS,TEACH CS,6,3,3
1991,LAS,TEACH CS,5,4,1
